NO              ./textures/n.xpm          

C           150,         184    , 255     
WE               ./textures/w.xpm
EA     ./textures/e.xpm
F             222    ,174, 98




SO           ./textures/s.xpm         



        1111111111111 11111111111
        10000000001   10000000001
        10110000011   10000000001
        10010000001   10000000001
11111111101100000111110000000001
100000000011000001110111110111111
11111111111111011100000010001
       111101110101001000111
11111111111111111100000000001
1000000001       100000010N01
1000000001       101011111111
1100000111111111 1011
11110111 1110101 101111111111
11111111 1111111 111111111111