NO ./images/bluestone.xpm
SO ./images/mossy.xpm
WE ./images/purplestone.xpm
EA ./images/redbrick.xpm
F 220,100,0
C 225,30,0 

111111
100101
101001
1N0001
111111