NO ./images/bluestone.xpm
SO ./images/mossy.xpm
WE ./images/purplestone.xpm
EA ./images/redbrick.xpm
F 92,64,51
C 173,216,230 

111111
100101
101001
100001
100001
100N01
100001
111111