/* XPM */
static char *LAB_1B1678364877[] = {
/* columns rows colors chars-per-pixel */
"64 64 15 1 ",
"  c black",
". c #141413",
"X c #181817",
"o c #1E1E17",
"O c #1C1C1B",
"+ c #28261F",
"@ c #28271F",
"# c #322E1D",
"$ c #382B2F",
"% c #353929",
"& c #373C2C",
"* c #44402F",
"= c #4F4C3F",
"- c #66684C",
"; c #818556",
/* pixels */
"                                                                ",
"=============&=&===========&========&=&====#=###===========&=&==",
"&&&&&&&&&&&&&&&&&&&&&&&&&&&&&&&&&&&&&&&&&&&&&#&#&&&&&&&&&&&&&&&&",
"&&&&&&&&&&&&&&&&&&&&&&&&&&&&&&&&&&&&&&&&&&&&&##&&&&&&&&&&&&&&&&&",
"&&&&&&&&&&&&&&&&&&&&&&&&&&&&&&&&&&&&&&&&&&&&&##&&&&&&&&&&&&&&&&&",
"&&&&&&&&&&&&&&&&&&&&&&&&&&&&&&&&&&&&&&&&&&&&&##&&&&&&&&&&&&&&&&&",
"&&&&&&&&&&&&&&&&&&&&&&&&&&&&&&&&&&&&&&&&&&&&&##&&&&&&&&&&&&&&&&&",
"&&&&&&&&&&&&&&&&&&&&&&&&&&&&&&&&&&&&&&&&&&&&&##&&&&&&&&&&&&&&&&&",
"=============================================**=================",
"&&&&&&&&&&&&&&&&&&&&&&&&&&&&&&&&&&&&&&&&&&&&&##&&&&&&&&&&&&&&&&&",
"=============================================**=================",
"=============================================**=================",
"==============================================*=================",
"=============================================*==================",
"==============================================*=================",
"================================================================",
"==============================================*=================",
"================================================================",
"================================================================",
"================================================================",
"================================================================",
"================================================================",
"==================-=============================================",
"=================-&=============================================",
"================;$*=============================================",
"===============-$**=================&-===============-==========",
"================**=================$-===============-&==========",
"================***====-===========-===============;$*==========",
"================**====;&==========-=========&=====-$**==========",
"================**===-$*=================&=$=======***==========",
"================***===**================&-$=&-=====**===========",
"================**====*================$;&=$;======*=*==========",
"================***===**=============-$;==&-=======**===========",
"================**====**============-$;==&=========*============",
"=====-==========*=*===*============-$*=============**===========",
"====;&==========**====**===========$**=============**===========",
"===-$*==========*=====*=============*==============*============",
"===&**==========**=====*============**=============**===========",
"====*===========**====*=============*==============*============",
"====**==========*====================*==============*===========",
"====*===========**====*=============*==============*============",
"=====*==========*===============================================",
"====*============*====*=============*==============*============",
"================*===============================================",
"====*==============================================*============",
"================*===============================================",
"================================================================",
"================*===============================================",
"================================================================",
"================================================================",
"================================================================",
"================================================================",
"================================================================",
"-------------------------------------------=-=-=---=-=-=-=------",
"                               .O.                              ",
"O  OO. OO  OO. OO  OO. OO  OO. OO  OO. OO  OO. OO  OO. OO  OO. O",
"%%%%%%%%%@%%%%@%@%@%@%@@@@@@%@%@%@%%%%%%%%%%%%%%%%%%%%%%%@%%%%@%",
"ooooooooXooooooooooooooooXooooooXoooooooXoooooooXoXoooooXooooooo",
"oXoooooXoooooooooooooooXXoooooooooooooo@@@oooooooXoooooXoooooooo",
"Xoo%.oooooo%.oooooo%.ooXoo@%.oooooo%.o@o@oo%.oooXoo%.oooooo%.ooo",
"ooX .oooooX .oooooX .oXoXoX .ooXooX .oo@ooX .ooXooX .oooooX .ooX",
"XoXXooooooXXooooooXXoooXooXX@oooooXXoo@oooXXooXXooXXooooooXXooXo",
"ooooooooooooooooooooooXoooo@@oooooooo@ooooooooXooooooooooooooXoX",
".XXXXXX.X.X.......X.X. . .    . ........X.X..X.X.XXXXXX.X.X....."
};
