/* XPM */
static char *LAB_5B1678366330[] = {
/* columns rows colors chars-per-pixel */
"64 64 21 1 ",
"  c black",
". c #141413",
"X c #181817",
"o c #1E1E17",
"O c #1C1C1B",
"+ c #28221F",
"@ c #28261F",
"# c #28271F",
"$ c #322E1D",
"% c #353929",
"& c #37382C",
"* c #373C2C",
"= c #075929",
"- c #1D783C",
"; c #4F4C3F",
": c #66684C",
"> c #289237",
", c #AFDA2F",
"< c #FFEC24",
"1 c #818556",
"2 c #A0B652",
/* pixels */
"                                                                ",
";;;;;;;;;;;;;*;*;;;;;;..;;;;;;*;*;;;;*;*..;;;;;;;;;;;;;;;;;*;*;;",
"**********************.O;**************$..**********************",
"**********************.O;*:**::::;***:*$.O**********************",
"**********************.O;$**:$$$$$$*$**$.O**********************",
"**********************.+;**:$$$$$$$$;**$.O**********************",
"**********************.O;*:$$$=>>=$$$;*$.+**********************",
"**********************.+;*:$$=>-->=$$:*$.O**********************",
";;;;;;;;;;;;;;;;;;;;;;.O;*:$$>-,<->$$:*$.+;;;;;;;;;;;;;;;;;;;;;;",
"**********************..;*:$$>-<,->$$:*$.O**********************",
";;;;;;;;;;;;;;;;;;;;;;.O:;2**=>-->=**2;*.+;;;;;;;;;;;;;;;;;;;;;;",
";;;;;;;;;;;;;;;;;;;;;;..;*:$$$=>>=$$$2*$.O;;;;;;;;;;;;;;;;;;;;;;",
";;;;;;;;;;;;;;;;;;;;;1..:;;:********2;;*..;;;;;;;;;;;;;;;;;;;;;;",
";;;;;;;;;;;;;;;;;;;;;;..:;;;:******2;;;$.O1;;;;;;;;;;;;;;;;;;;;;",
";;;;;;;;;;;;;;;;;;;;;1.O:;;;;:2:222;;;;*..;;;;;;;;;;;;;;;;;;;;;;",
";;;;;;;;;;;;;;;;;;;;;1O+:;;;;;;;;;;;;;;$..1;;;;;;;;;;;;;;;;;;;;;",
";;;;;;;;;;;;;;;;;;;;;1OO;***$*$$$$$$$$$$ .1;;;;;;;;;;;;;;;;;;;;;",
";;;;;;;;;;;;;;;;;;;;;1OO..  .            .1;;;;;;;;;;;;;;;;;;;;;",
";;;;;;;;;;;;;;;;;;;;;:&OO+O+O...OOOOO+O+O&:;;;;;;;;;;;;;;;;;;;;;",
";;;;;;;;;;;;;;;;;;;;;;:1111222,..,2212111:;;;;;;;;;;;;;;;;;;;;;;",
";;;;;;;;;;;;;;;;;;;;;;;;;;;;;:2+.2:;;;;;;;;;;;;;;;;;;;;;;;;;;;;;",
";;;;;;;;;;;;;;;;;;;;;;;;;;;;;;1..1;;;;;;;;;;;;;;;;;;;;;;;;;;;;;;",
";;;;;;;;;;;;;;;;;;;;;;;;;;;;;;1+.1;;;;;;;;;;;;;;;;;;;;;;;;;;;;;;",
";;;;;;;;;;;;;;;;;;;;;;;;;;;;;;1..1;;;;;;;;;;;;;;;;;;;;;;;;;;;;;;",
";;;;;;;;;;;;;;;;;;;;;;;;;;;;;;1..1;;;;;;;;;;;;;;;;;;;;;;;;;;;;;;",
";;;;;;;;;;;;;;;;;;;;;;;;;;;;;;1..1;;;;;;;;;;;;;;;;;;;;;;;;;;;;;;",
";;;;;;;;;;;;;;;;;;;;;;;;;;;;;;1..1;;;;;;;;;;;;;;;;;;;;;;;;;;;;;;",
";;;;;;;;;;;;;;;;;;;;;;;;;;;;;;:..1;;;;;;;;;;;;;;;;;;;;;;;;;;;;;;",
";;;;;;;;;;;;;;;;;;;;;;;;;;;;;;1..1;;;;;;;;;;;;;;;;;;;;;;;;;;;;;;",
";;;;;;;;;;;;;;;;;;;;;;;;;;;;;;:..1;;;;;;;;;;;;;;;;;;;;;;;;;;;;;;",
";;;;;;;;;;;;;;;;;;;;;;;;;;;;;;1..1;;;;;;;;;;;;;;;;;;;;;;;;;;;;;;",
";;;;;;;;;;;;;;;;;;;;;;;;;;;;;;:.+1;;;;;;;;;;;;;;;;;;;;;;;;;;;;;;",
";;;;;;;;;;;;;;;;;;;;;;;;;;;;;;:+.1;;;;;;;;;;;;;;;;;;;;;;;;;;;;;;",
";;;;;;;;;;;;;;;;;;;;;;;;;;;;;;:.+:;;;;;;;;;;;;;;;;;;;;;;;;;;;;;;",
";;;;;;;;;;;;;;;;;;;;;;;;;;;;;;:+.1;;;;;;;;;;;;;;;;;;;;;;;;;;;;;;",
";;;;;;;;;;;;;;;;;;;;;;;;;;;;;;:.+:;;;;;;;;;;;;;;;;;;;;;;;;;;;;;;",
";;;;;;;;;;;;;;;;;;;;;;;;;;;;;;:++1;;;;;;;;;;;;;;;;;;;;;;;;;;;;;;",
";;;;;;;;;;;;;;;;;;;;;;;;;;;;;;:.+:;;;;;;;;;;;;;;;;;;;;;;;;;;;;;;",
";;;;;;;;;;;;;;;;;;;;;;;;;;;;;;:++:;;;;;;;;;;;;;;;;;;;;;;;;;;;;;;",
";;;;;;;;;;;;;;;;;;;;;;;;;;;;;;:.+:;;;;;;;;;;;;;;;;;;;;;;;;;;;;;;",
";;;;;;;;;;;;;;;;;;;;;;;;;;;;;;;.O:;;;;;;;;;;;;;;;;;;;;;;;;;;;;;;",
";;;;;;;;;;;;;;;;;;;;;;;;;;;;;;:.+:;;;;;;;;;;;;;;;;;;;;;;;;;;;;;;",
";;;;;;;;;;;;;;;;;;;;;;;;;;;;;;;.O;;;;;;;;;;;;;;;;;;;;;;;;;;;;;;;",
";;;;;;;;;;;;;;;;;;;;;;;;;;;;;;;.+:;;;;;;;;;;;;;;;;;;;;;;;;;;;;;;",
";;;;;;;;;;;;;;;;;;;;;;;;;;;;;;;.O;;;;;;;;;;;;;;;;;;;;;;;;;;;;;;;",
";;;;;;;;;;;;;;;;;;;;;;;;;;;;;;;..:;;;;;;;;;;;;;;;;;;;;;;;;;;;;;;",
";;;;;;;;;;;;;;;;;;;;;;;;;;;;;;;.O;;;;;;;;;;;;;;;;;;;;;;;;;;;;;;;",
";;;;;;;;;;;;;;;;;;;;;;;;;;;;;;;..;;;;;;;;;;;;;;;;;;;;;;;;;;;;;;;",
";;;;;;;;;;;;;;;;;;;;;;;;;;;;;;;..;;;;;;;;;;;;;;;;;;;;;;;;;;;;;;;",
";;;;;;;;;;;;;;;;;;;;;;;;;$1*;;;..;;$1*;;;;;;;;;;;;;;;;;;;;;;;;;;",
";;;;;;;;;;;;;;;;;;;;;;;;;$**;;;..;;$**;;;;;;;;;;;;;;;;;;;;;;;;;;",
";;;;;;;;;;;;;;;;;;;;;;;;;$$;;;;..;;$$;;;;;;;;;;;;;;;;;;;;;;;;;;;",
";;;;;;;;;;;;;;;;;;;;;;;;;;;;;;;.O;;;;;;;;;;;;;;;;;;;;;;;;;;;;;;;",
"::::::::::::::::::::::::::::;:;..;:;:::::::;:;:;:::;:;:;:;::::::",
"                               .O.                              ",
"O  OO. OO  OO. OO  OO. OO  OO. OO  OO. OO  OO. OO  OO. OO  OO. O",
"%%%%%%%%%#%%%%#%#%#%#%######%#%#%#%%%%%%%%%%%%%%%%%%%%%%%#%%%%#%",
"ooooooooXooooooooooooooooXooooooXoooooooXoooooooXoXoooooXooooooo",
"oXoooooXoooooooooooooooXXoooooooooooooo###oooooooXoooooXoooooooo",
"Xoo%.oooooo%.oooooo%.ooXoo#%.oooooo%.o#o#oo%.oooXoo%.oooooo%.ooo",
"ooX .oooooX .oooooX .oXoXoX .ooXooX .oo#ooX .ooXooX .oooooX .ooX",
"XoXXooooooXXooooooXXoooXooXX#oooooXXoo#oooXXooXXooXXooooooXXooXo",
"ooooooooooooooooooooooXoooo##oooooooo#ooooooooXooooooooooooooXoX",
".XXXXXX.X.X.......X.X. . .    . ........X.X..X.X.XXXXXX.X.X....."
};
