/* XPM */
static char *BRICK_3A1678366329[] = {
/* columns rows colors chars-per-pixel */
"64 64 18 1 ",
"  c #170606",
". c #1B1B1A",
"X c #28221F",
"o c #2E221C",
"O c #3B2921",
"+ c #463124",
"@ c #383F40",
"# c #4F4C48",
"$ c #5B5952",
"% c #67625C",
"& c #79735E",
"* c #666A62",
"= c #756F64",
"- c #807B6A",
"; c #89928C",
": c #93968B",
"> c #9F9F8B",
", c #A1A9A3",
/* pixels */
"OoOO++O+OOOOoooooOoO+++O+OOOOOOOOoOooooOOOOOoooooOoOoo+O+OOOOOOO",
"&%$##+-,;--&&---&%$##+:,;--&&$--&%$##O-,;::&&&&&&%$#o+O-,>---$--",
"%$%$XO>*%%%%&-%%%$%$XO>*%%%&*-*%%$%$Xo>*%%%&**%%%*%$XO+:*%%%&-*%",
"%%$%@O-%%%%**%%%%%$%@o-%%%&*%*%%%%$%@O-%%%&*%%%%*%%%@+--%%%***%%",
"%%%%XO#$%%%=#%%%%%%%XO#$%%%=#%%%%%%%Xo-%%-%%*=###$%$Xo%$%%%=#%%%",
"%%%$XO$%%%%##%%%%%%$XO$%%=###%%%%%%$XO$%%=##%#$#%%$$Xo$%$%%##%%%",
"#%%#XO$##%$@@%%##%%#.O$#####$%%##%%#XO$####$%%#%#$%#Xo#$%%$@@%%#",
"@@XX@+#XXXXX@@@@@@X.@+.XXX@X@..X@@XX@+#XXX@@@@@@@@XX@o#X@XXX@@@@",
"ooOoOOooOOoOooooooOoOOo+o+OooooOOOOOOOoooooOoOOooOoOOOOOOOOoOOOo",
"-:----#-$###$$#+&-&&&&@$$%%$#@@O-,>>---$$###$$++-,:----&&&&%$##+",
"-*%%%%%&-%#$$%XO-*$$$$$$$*$*$#.o:&&&%%&-%%#$%#X+:%%-*%**%%%*%$XO",
"-%%&%%%%%%%$%$X+&$$%$$$$$$$$$$XO&%&%*&%%%%%%%#XO$$%$%%%%%%*%%%@+",
"#%$%%%%$%%#$%$@O&*$$$$$$@@@#$#.O&**%*%%%%%$%%$Xo#%$%%%%=#$#$%$Xo",
"#$%$%$%%%$#%$%XO#$$$$$$##@$$##.+%*%*%%$%%$%%%%@o#$%$%%%#$#%%$$XO",
"##$%$%$%%$#$$#XO@#$@@@$@@$@#$@.O$%%%%#%%%%%%%%Xo##$%$%%%#%#$%#Xo",
"#XXX@@@@@@@XX.@+@.X.XXX.XXXX..X+OX@X@@X@ @@XX.@o#XXX@X@@@@@@XX@O",
"oooooOoO+++O+OOOOOOOOoOooooOOOOOoooooOoOoo+O+OOOOOOOOoOO++O+OOOO",
"%-&&%$#@#+-,;--&&$--&%$##O-,;::&&&&&&%$##+O-,>---$--&%$##+$>---%",
"%&$$$#$#.O>*%%%&*-*%%$%$Xo>*%%%&**%%%*%$XO+:*%%%&-*%%$%$XO-*$$$$",
"*$$$$$#$Xo-%%%&*%*%%%%$%@O-%%%&*%%%%*%%%@+--%%%***%%%%$%@O&$$$$*",
"@$$$$$$$.O#$%%%=#%%%%%%%Xo-%%-%%*=###$%$Xo%$%%%=#%%%%%%%XO@#$$$%",
"@$$$$$$#.O$%%=###%%%%%%$XO$%%=##%#$#%%$$Xo$%$%%##%%%%%%$XO#$$$$@",
"X$$@@$$@.O$#####$%%##%%#XO$####$%%#%#$%#Xo#$%%$@@%%##%%#XO#@@$#X",
"XXXXXX..X+#XXX@X@..X@@XX@+#XXX@@@@@@@@XX@oXX@XXX@@@@@@XX@+@.....",
"OoOOOOOOOOoOOOoooOoOOooOOoOooooooOoOOo+o+OooooOOOOOOOoooooOoOOoo",
",:----&&&&%$##+&$&&&&@&$@@@##@+-:----#%%&&%$##O&>---&&$$@@@##@+-",
"%%-*%**%%%*%$XO-*$$$$$%&$@##$.O-*%%%%%%%*%*%$Xo$%%%$$%&$$@#$@.+:",
"$%$%%%%%%*%%%@+&$$%$$$$$$$#$#.+-%%&%%%%%%%%%%@O%$%$*%$$$$$$$@.O$",
"%$%%%%=###$%$Xo@$#$$$$#$$@#$#XO-*%%%%%%###$%$XO%**$*$$$$$#$$#.o#",
"$%$%%%#$#%%$$XO@#$#$#$$$#@$#$.O$%%%%%%$$#%%$$X+$*$*$$#$$#$$$$Xo#",
"#$%$%%%#%#$%#Xo@@#$#$#$$#@##@.O#$%###%##%#$%#XO#$$$$@$$$$$$$$.o#",
"XXX@X@@@@@@XX@O@...XXXXXXX...X+@X@X@@@X@@@@XX@+@.X.XX.X XX...Xo#",
"oOO++O+OOOOoooooOoO+++O+OOOOOOOOoOooooOOOOOoooooOoOoo+O+OOOOOOOO",
"%$##+&>---%%-&&%$#@@+:,;--&&$--&%$##O-,;::&&&&&&%$#o+O-,>---$--&",
"$%$XO-*$$$$%&$$$#$#.O>*%%%&*-*%%$%$Xo>*%%%&**%%%*%$XO+:*%%%&-*%%",
"%$%@O&$$$$**$$$$$#$Xo-%%%&*%*%%%%$%@O-%%%&*%%%%*%%%@+--%%%***%%%",
"%%%XO@#$$$%@$$$$$$$.O#$%%%=#%%%%%%%Xo-%%-%%*=#$#$%$Xo%$%%%=#%%%%",
"%%$XO#$$$$@@$$$$$$#.O$%%=###%%%%%%$XO$%%=##%#$#%%$$Xo$%$%%##%%%%",
"%%#XO#@@$#XX$$@@$$@.O$#####$%%##%%#XO$####$%%#%#$%#Xo#$%%$@@%%##",
"@XX@+@.....XXXXXX..X+.XXX@X@..X@@XX@+#XXX@@@@@@@@XX@o#X@XXX@@@@@",
"oooOoOOooOOoOooooooOoOOo+o+OooooOOOOOOOoooooOoOOooOoOOOOOOOOoOOO",
"+-:----#-$###$$#+-:----#%%&&%$##O-,>>---$$###$$@+-,:----&&&&%$##",
"O-*%%%%%&-%#$$%XO-*%%%%%%%*%*%$Xo:&&&%%&-%%#$%#X+:%%-*%**%%%*%$X",
"+-%%&%%%%%%%$%$X+-%%&%%%%%%%%%%@O&%&%*&%%%%%%%#XO$$%$%%%%%%*%%%@",
"o#%$%%%%$%%#$%$@O-*%%%%%%#$#$%$XO&**%*%%%%%$%%$Xo#%$%%%%=###$%$X",
"O#$%$%$%%%$#%$%XO$%%%%%%$$#%%$$X+%*%*%%$%%$%%%%@o#$%$%%%#$#%%$$X",
"o##$%$%$%%$#$$#XO#$%###%##%#$%#XO$%%%%#%%%%%%%%Xo##$%$%%%#%#$%#X",
"O#XXX@@@@@@@XX.@+#X@X@@@X@@@@XX@+@X@X@@X@ @@XX.@o#XXX@X@@@@@@XX@",
"ooOoO+++O+OOOOOOOOoOooooOOOOOoooooOoOoo+O+OOOOOOOOoOO++O+OOOOooo",
"-&%$#$+-,;--&&$--&%$##O-,;::&&&&&&%$##+O&>-&&&#--%$#@@+:,;--&&--",
"%%$%$XO>*%%%&*-*%%$%$Xo>*%%%&**%%%*%$XO+$*$$$%-*$$#$#.O>*%%%%&-%",
"%%%$%@o-%%%&*%*%%%%$%@O-%%%&*%%%%*%%%@+&-$$$***$$$$#$XO-%%%%**%%",
"%%%%%XO#$%%%=#%%%%%%%Xo-%%-%%*=#$#$%$Xo$#$$$%@$$$$$$$.O#$%%%=#%%",
"%%%%$XO$%%=###%%%%%%$XO$%%=##%#$#%%$$Xo#$#$$@@$$$$$$#.O$%%%%##%%",
"##%%#.O$#####$%%##%%#XO$####$%%#%#$%#Xo@#$$#XX$$@@$$@.O$##%$@@%%",
"@@@X.@+#XXX@X@..X@@XX@+#XXX@@@@@@@@XX@o..X...XXXXXX..X+#XXXXX@@@",
"OOOOoooooOoOOooOoOOOOOOOOoOOOoooOoOOooOOoOooooooOoOOo+o+OooooOOO",
">>---$$###$$#+-,:----&&&&%$##+-:----#-$###$$#+&$&&&&@$$%%$#@@O-,",
"&&%%&-%%#$%#X+:%%-*%**%%%*%$XO-*%%%%%&-%#$$%XO-*$$$$$$$*$*$#.o:&",
"&%*&%%%%%%%#XO$$%$%%%%%%*%%%@+-%%&%%%%%%%$%$X+&$$%$$$$$$$$$$XO&%",
"*%*%%%%%$%%$Xo#%$%%%%=###$%$Xo#%$%%%%$%%#$%$@O&*$$$$$$@@@#$#.O&*",
"%*%%$%%$%%%%@o#$%$%%%#$#%%$$XO#$%$%$%%%$#%$%XO#$$$$$$##@$$##.+%*",
"%%%#%%%%%%%%Xo##$%$%%%#%#$%#Xo##$%$%$%%$#$$#XO@#$@@@$@@$@#$@.O$%",
"@X@@X@ @@XX.@o#XXX@X@@@@@@XX@O#XXX@@@@@@@XX.@+X.X.XXX.XXXX..X+#X"
};
