/* XPM */
static char *TILE_1G1678375611[] = {
/* columns rows colors chars-per-pixel */
"64 64 25 1 ",
"  c black",
". c #28221F",
"X c #206134",
"o c #377B36",
"O c #405638",
"+ c #383F40",
"@ c #003C75",
"# c #4E595A",
"$ c #5A7B48",
"% c #616257",
"& c #536265",
"* c #5B6F73",
"= c #62797E",
"- c #65A117",
"; c #4E9129",
": c #7E9154",
"> c #005A97",
", c #00749C",
"< c #7C9193",
"1 c #888D82",
"2 c #89928C",
"3 c #93968B",
"4 c #869A9C",
"5 c #9BACAA",
"6 c #A1A9A3",
/* pixels */
"56233:::::::&#O  ..+.++#11::&#O.56233:::::::&#O 5444===%%1::&#O ",
"4$&&&:$$&&&$$&#.4111::11$&&&#&#.4$&&&:$$&&&$$&#.3$&&&&:=&&&&#&#.",
"=&&&:$&&&&$$&&&+4$&&&:$$&&&&&#&+=&&&:$&&&&$$&&&+$&&&$:&&&&&&&#&+",
"=&&=&&$&$$$&&&O.4&&&:$&&&&&&&&&.=&&=&&$&$$$&&&O.:&&==&&&&&&&&&&.",
"=&$=&$&$$&&&&&O+=&&=&&&&&&&&&&#.=&$=&$&$$&&&&&O+:&:&&&&&&&&&&&#.",
"=&:&&&$&&&&&&O&+=&$=&$&&&&&&*O+.=&:&&&$&&&&&&O&+::$&&&&&&&&&*O+.",
"=:&&&$&&&&#&#&&+=:$&$&$&&&&*OO++=:&&&$&&&&#&#&&+=:$&$&$&&&&*OO++",
"%=&&&&&&&&O&&&&+1:$$&$&&&&**OO+.%=&&&&&&&&O&&&&+1:$$&$&&&&**OO+.",
"%&&&&&&&&OO&&&&+1:$&$$&&&*OO#O++%&&&&&&&&OO&&&&+1:$&$$&&&*OO#O++",
"O&&&&&&&*O#&#&&+:$&&&&&#&O#&&#O+O&&&&&&&*O#&#&&+:$&&&&&#&O#&&#O+",
"OO&&&&&*O#&#&&&+$&&&&&#&##&&&&O+OO&&&&&*O#&#&&&+$&&&&&#&##&&&&O+",
"OO&&&&*O#&#&#&&+&&&&&#&#&&&&&&&+OO&&&&*O#&#&#&&+&&&&&#&#&&&&&&&+",
"O#&&&*O#&#&&&&&.&&&&#&#&&&&&&&&.O#&&&*O#&#&&&&&.&&&&#&#&&&&&&&&.",
"#&&*OOO&&&&&&&#.#&&&&&&&&&&&&&#.#&&*OOO&&&&&&&#.#&&&&&&&&&&&&&#.",
"#OOOOO#&&OO#&&O #OOO&&+&&OO#&XOoX;OOOO#&&OO#&&O.#OOO&&&&&OO#&&O ",
" ...+.+++++.+.  ....+.X+oX+.+;-X;--o+.+++++.+..  ...+.+++++.+.  ",
"53$:::::::::&#O.<1$::$.-X.O==O+.X.X+===%%OOOO## <<===O+OO###OOO ",
"4$&&&:$$&&&$$&#.<$&&=$o;;-+$$&#.+$&&&&:=&&OO##&.1$&&&&O+#&&&&#O.",
"4&&&:$&&&&$$&&&+=&&=$&Oo;oX$&&&+$&&&$:&&&&&&#&#.$&&=&&#O&&&&#&#.",
"4&&=&&&&$$$&$&O.=&=&&$&-oXO&&&O.:&&==&&&&&&&&##.:&=&&&&O&&&&&#&.",
"=&$=&&&$$$&$&&O+=&&&&&&XO==&&&O+:&:&&&&&&&&&#&#+:=$&&&#&O&&&&&#+",
"=&:&&&&&$&$&&O&+O&&&&&&&&&=&&&&+::$&&&&&&&&#&#O.$$&$&&&#O&&&&&&.",
"=:&&&&&$&&&&#&&++O#&#&&&&#&&&&&+:$&&&&&&&&&&*OO+O&$&&&&&O&#&&&&+",
"%=&&&&&&&&&&&&&+O+OO&#&##&#&&&&+:$&&$&$&&&&&*O&..$$&&&&##O&&&&&+",
"%&&&&&&&&&&&&&#+O#&&OOO#&&&&&&&+:&&$$$&&&&&*O#O.@++#&&&#&&#&&&*+",
"O&&&&&&&&&&&&##+#&&&&&&O&&&&&&&+:&&$$&&&&&&*OO&.>>,,#&#&&&&&&*O+",
"OO&&&&&&&&&#OOO+#&&&&&#&#&&*&&&.:&$$&$&&&&&#O&O+>5<===&#&&&**#O+",
"OO&&&#&&**#O&#&+#&&&&&&&&&*##&#.:$$&$&&&&&#O&O&.<$$&&&&&&&*##&#.",
"O##&#&**OOO&#&#.O&#&&&&&&&*#&&+.&$&$&&#&&&O&#-#X=$&&&&&&&&&#&##+",
"##&#&#OO#O&O&##.O#&#&&&&&*#&##.@.&&&&O&&&#O#&-o-#X&&&&&&&&&&&#+.",
"#&###OO&O&O&#&O.OO#&#&&&*OO##+ >>+&OO&&&##O&##;X-.&OO-&&&&&#+.. ",
"....+.+++++.+.. ....+.+++++.+.@>,.+.+++++++.X;X;-X;o;Xo.++.. .  ",
"56233:::::::&#O.53$:::::::::&#=,,,44===11:$&;O..o;.oX.+#11::&#O ",
"4$&&&:$$&&&$$&#.4$&&&:$$&&&$$&#=,5$&&&:::$&&&&O -X11::11$&&&#&#.",
"=&&&:$&&&&$$&&&+4&&&:$&&&&$$&&&+.1&&&$$$$&&&&&Oo&$&&&:$$&&&&&#&+",
"=&&=&&$&$$$&&&O.4&&=&&&&$$$&$&O.+1&&==&$&&&&&&O;O&&&:$&&&&&&&&&.",
"=&$=&$&$$&&&&&O+=&$=&&&$$$&$&&O+.:&:&&$&$&&&#&-oO&&=&&&&&&&&&&#.",
"=&:&&&$&&&&&&O&+=&:&&&&&$&$&&O&++::$&$&$$&&#&&&XO&$=&$&&&&&&*O+.",
"=:&&&$&&&&#&#&&+=:&&&&&$&&&&#&&++1$&&&$&&&#&#&&+=:$&$&$&&&&*OO++",
"%=&&&&&&&&O&&&&+%=&&&&&&&&&&&&&+#1$&&&&&&#&#&&&+1:$$&$&&&&**OO+.",
"%&&&&&&&&OO&&&&+%&&&&&&&&&&&&&#+1$&&&&&&&&#&&&&+1:$&$$&&&*OO#O++",
"O&&&&&&&*O#&#&&+O&&&&&&&&&&&&##+1&&&&&&&*O#&&&O+:$&&&&&#&O#&&#O+",
"OO&&&&&*O#&#&&&o+O&&&&&&&&&#OOO+:&&&&&&*O#&&&&O+$&&&&&#&##&&&&O+",
"OO&&&&*O#&#&#&&o+O&&&#&&**#O&#&+:&&&&&**O&&&&&#.&&&&&#&#&&&&&&&+",
"O#&&&*O#&#&&&&-;+#o&#&**OOO&#&#.&#&&&*OO#&&&&&&+&&&&#&#&&&&&&&&.",
"#&&*OOO&&&&&&ooXXo&#&#OO#O&O&##.#&#&&OOOO#&&&&&.#&&&&&&&&&&&&&#.",
"#OOOOO#&&OO#&&o-Xo###OO&;&O&#&O.O#&&#++++OO&&#O.#OOO&&&&&OO#&&O.",
"....+.+++++.X;-;-;oX+.X;-;-X;X. ..+...+.++++... ....+.+...+.+.. ",
"53$:::::::::&o.X;;+====.;o.o+## 53$:::::::::&#O.<1$::$O.@>><=#O.",
"4$&&&:$$&&&$$&#;.oOo&&:=OOOO#&O.4$&&&:$$&&&$$&#.<$&&=$&$+,<$$&#.",
"4&&&:$&&&&$$&&o+&Oo&$:&&&&&&&&O.4&&&:$&&&&$$&&&+=&&=$&$$+,1$&&&+",
"4&&=&&&&$$$&$&O.3&&==&&&&&&&&*O.4&&=&&&&$$$&$&O.=&=&&$&&#,=&&&O.",
"=&$=&&&$$$&$&&O+3&:&&&&&&&&&&OO+=&$=&&&$$$&$&&O+=&&&&&&&&#=&&&OX",
"=&:&&&&&$&$&&O&+::$&$&$&&&&&*OO.=&:&&&&&$&$&&O&+O&&&&&&&&&=&&&&o",
";:&&&&&$&&&&#&&+:$&$&$&&&&&*OO#+=:&&&&&$&&&&#&&++O#&#&&&&#&&&&+o",
".O&&&&&&&&&&&&&+:$&&$&&&&&*O#&&+%=&&&&&&&&&&&&&+O+OO&#&##&#&&#X-",
"XO&&&&&&&&&&&&#+:&&$$&&&&*O#&&&+%&&&&&&&&&&&&&#+O#&&OOO#&&&&##;-",
".&&&&&&&&&&&&##+:&&$&&&&OO#&#&O+O&&&&&&&&&&&&##+#&&&&&&O&&&&&+Xo",
";O&&&&&&&&&#OOO+:&$$&&#OO#&#&&O+OO&&&&&&&&&#OOO+#&&&&&#&#&&*&&.X",
"+O&&&#&&**#O&#&+:$$&&&&&&&#&&&#.OO&&&#&&**#O&#&+#&&&&&&&&&*##&#-",
"O##&#&**OOO&#&#.&$&&&&#&&#&#&&&+O##&#&**OOO&#&#.O&#&&&&&&&*#&&+;",
"##&#&#OO#O&O&##.#&&&&O&&&&&&&&&.##&#&#OO#O&O&##.O#&#&&&&&*#&##.X",
"#&###OO&O&O&#&O.O#&OO&&&&&&&&#O.#&###OO&O&O&#&O.OO#&#&&&*OO##+.X",
"....+.+++++.+..  .+.++++++++... ....+.+++++.+.. ....+.+++++.+.. "
};
