/* XPM */
static char *TILE_2E1678375611[] = {
/* columns rows colors chars-per-pixel */
"64 64 21 1 ",
"  c black",
". c #28221F",
"X c #383F40",
"o c #003C75",
"O c #464D4F",
"+ c #4E595A",
"@ c #616257",
"# c #79735E",
"$ c #536265",
"% c #5B6F73",
"& c #666A62",
"* c #62797E",
"= c #005A97",
"- c #00749C",
"; c #7C9193",
": c #888D82",
"> c #89928C",
", c #93968B",
"< c #869A9C",
"1 c #9BACAA",
"2 c #A1A9A3",
/* pixels */
"12>,,#######$+O  ..X.XX+::##$+O.12>,,#######$+O 1<<<***@@:##$+O ",
"<&$$$#&&$$$&&$+.<:::##::&$$$+$+.<&$$$#&&$$$&&$+.,&$$$$#*$$$$+$+.",
"*$$$#&$$$$&&$$$X<&$$$#&&$$$$$+$X*$$$#&$$$$&&$$$X&$$$&#$$$$$$$+$X",
"*$$*$$&$&&&$$$O.<$$$#&$$$$$$$$$.*$$*$$&$&&&$$$O.#$$**$$$$$$$$$$.",
"*$&*$&$&&$$$$$OX*$$*$$$$$$$$$$+.*$&*$&$&&$$$$$OX#$#$$$$$$$$$$$+.",
"*$#$$$&$$$$$$O$X*$&*$&$$$$$$%OX.*$#$$$&$$$$$$O$X##&$$$$$$$$$%OX.",
"*#$$$&$$$$+$+$$X*#&$&$&$$$$%OOXX*#$$$&$$$$+$+$$X*#&$&$&$$$$%OOXX",
"@*$$$$$$$$O$$$$X:#&&$&$$$$%%OOX.@*$$$$$$$$O$$$$X:#&&$&$$$$%%OOX.",
"@$$$$$$$$OO$$$$X:#&$&&$$$%OO+OXX@$$$$$$$$OO$$$$X:#&$&&$$$%OO+OXX",
"O$$$$$$$%O+$+$$X#&$$$$$+$O+$$+OXO$$$$$$$%O+$+$$X#&$$$$$+$O+$$+OX",
"OO$$$$$%O+$+$$$X&$$$$$+$++$$$$OXOO$$$$$%O+$+$$$X&$$$$$+$++$$$$OX",
"OO$$$$%O+$+$+$$X$$$$$+$+$$$$$$$XOO$$$$%O+$+$+$$X$$$$$+$+$$$$$$$X",
"O+$$$%O+$+$$$$$.$$$$+$+$$$$$$$$.O+$$$%O+$+$$$$$.$$$$+$+$$$$$$$$.",
"+$$%OOO$$$$$$$+.+$$$$$$$$$$$$$+.+$$%OOO$$$$$$$+.+$$$$$$$$$$$$$+.",
"+OOOOO+$$OO+$$O +OOO$$$$$OO+$$O.+OOOOO+$$OO+$$O.+OOO$$$$$OO+$$O ",
" ...X.XXXXX.X.  ....X.X..XX.X.. ....X.XXXXX.X..  ...X.XXXXX.X.  ",
"1,&#########$+O.;:&##&O.o==<*+O.1<<<***@@OOOO++ ;;***OXOO+++OOO ",
"<&$$$#&&$$$&&$+.;&$$*&$O=--#&$+.,&$$$$#*$$OO++$.:&$$$$OX+$$$$+O.",
"<$$$#&$$$$&&$$$X*$$*&$&&@-,&$$$X&$$$&#$$$$$$+$+.&$$*$$+O$$$$+$+.",
"<$$*$$$$&&&$&$O.*$*$$&$$*-<$$$O.#$$**$$$$$$$$++.#$*$$$$O$$$$$+$.",
"*$&*$$$&&&$&$$OX*$$$$$$$$**$$$OX#$#$$$$$$$$$+$+X#*&$$$+$O$$$$$+X",
"*$#$$$$$&$&$$O$XO$$$$$$$$$*$$$$X##&$$$$$$$$+$+O.&&$&$$$+O$$$$$$.",
"*#$$$$$&$$$$+$$XXO+$+$$$$+$$$$$X#&$$$$$$$$$$%OOXO$&$$$$$O$+$$$$X",
"@*$$$$$$$$$$$$$XOXOO$+$++$+$$$$X#&$$&$&$$$$$%O$..&&$$$$++O$$$$$X",
"@$$$$$$$$$$$$$+XO+$$OOO+$$$$$$$X#$$&&&$$$$$%O+O.oXX+$$$+$$+$$$%X",
"O$$$$$$$$$$$$++X+$$$$$$O$$$$$$$X#$$&&$$$$$$%OO$.==--+$+$$$$$$%OX",
"OO$$$$$$$$$+OOOX+$$$$$+$+$$%$$$.#$&&$&$$$$$+O$OX=1;***$+$$$%%+OX",
"OO$$$+$$%%+O$+$X+$$$$$$$$$%++$+.#&&$&$$$$$+O$O$.;&&$$$$$$$%++$+.",
"O++$+$%%OOO$+$+.O$+$$$$$$$%+$$X.$&$&$$+$$$O$+$+X*&$$$$$$$$$+$++X",
"++$+$+OO+O$O$++.O+$+$$$$$%+$++.o.$$$$O$$$+O+$+$.+$$$$$$$$$$$$+X.",
"+$+++OO$O$O$+$O.OO+$+$$$%OO++X ==X$OO$$$++O$++O.O+$OO$$$$$$+X.. ",
"....X.XXXXX.X.. ....X.XXXXX.X.o=-.X.XXXXXXXX..  ..X.XXXXXX.. .  ",
"12>,,#######$+O.1,&#########$+*---<<***::#&$$++. ..X.XX+::##$+O ",
"<&$$$#&&$$$&&$+.<&$$$#&&$$$&&$+*-1&$$$###&$$$$O <:::##::&$$$+$+.",
"*$$$#&$$$$&&$$$X<$$$#&$$$$&&$$$X.:$$$&&&&$$$$$O.<&$$$#&&$$$$$+$X",
"*$$*$$&$&&&$$$O.<$$*$$$$&&&$&$O.X:$$**$&$$$$$$O.<$$$#&$$$$$$$$$.",
"*$&*$&$&&$$$$$OX*$&*$$$&&&$&$$OX.#$#$$&$&$$$+$$X*$$*$$$$$$$$$$+.",
"*$#$$$&$$$$$$O$X*$#$$$$$&$&$$O$XX##&$&$&&$$+$$$.*$&*$&$$$$$$%OX.",
"*#$$$&$$$$+$+$$X*#$$$$$&$$$$+$$XX:&$$$&$$$+$+$$X*#&$&$&$$$$%OOXX",
"@*$$$$$$$$O$$$$X@*$$$$$$$$$$$$$X+:&$$$$$$+$+$$$X:#&&$&$$$$%%OOX.",
"@$$$$$$$$OO$$$$X@$$$$$$$$$$$$$+X:&$$$$$$$$+$$$$X:#&$&&$$$%OO+OXX",
"O$$$$$$$%O+$+$$XO$$$$$$$$$$$$++X:$$$$$$$%O+$$$OX#&$$$$$+$O+$$+OX",
"OO$$$$$%O+$+$$$XOO$$$$$$$$$+OOOX#$$$$$$%O+$$$$OX&$$$$$+$++$$$$OX",
"OO$$$$%O+$+$+$$XOO$$$+$$%%+O$+$X#$$$$$%%O$$$$$+.$$$$$+$+$$$$$$$X",
"O+$$$%O+$+$$$$$.O++$+$%%OOO$+$+.$+$$$%OO+$$$$$$X$$$$+$+$$$$$$$$.",
"+$$%OOO$$$$$$$+.++$+$+OO+O$O$++.+$+$$OOOO+$$$$$.+$$$$$$$$$$$$$+.",
"+OOOOO+$$OO+$$O +$+++OO$O$O$+$O.O+$$+XXXXOO$$+O.+OOO$$$$$OO+$$O.",
"....X.XXXXX.X.. ....X.XXXXX.X.. ..X...X.XXXX... ....X.X...X.X.. ",
"1,&#########$+O.1<*****@@OOOO++ 1,&#########$+O.;:&##&O.o==;*+O.",
"<&$$$#&&$$$&&$+.2&$$$$#*$$OO+$O.<&$$$#&&$$$&&$+.;&$$*&$&X-;&&$+.",
"<$$$#&$$$$&&$$$X>$$$&#$$$$$$$$O.<$$$#&$$$$&&$$$X*$$*&$&&X-:&$$$X",
"<$$*$$$$&&&$&$O.,$$**$$$$$$$$%O.<$$*$$$$&&&$&$O.*$*$$&$$+-*$$$O.",
"*$&*$$$&&&$&$$OX,$#$$$$$$$$$$OOX*$&*$$$&&&$&$$OX*$$$$$$$$+*$$$OX",
"*$#$$$$$&$&$$O$X##&$&$&$$$$$%OO.*$#$$$$$&$&$$O$XO$$$$$$$$$*$$$$X",
"*#$$$$$&$$$$+$$X#&$&$&$$$$$%OO+X*#$$$$$&$$$$+$$XXO+$+$$$$+$$$$$X",
"@*$$$$$$$$$$$$$X#&$$&$$$$$%O+$$X@*$$$$$$$$$$$$$XOXOO$+$++$+$$$$X",
"@$$$$$$$$$$$$$+X#$$&&$$$$%O+$$$X@$$$$$$$$$$$$$+XO+$$OOO+$$$$$$$X",
"O$$$$$$$$$$$$++X#$$&$$$$OO+$+$OXO$$$$$$$$$$$$++X+$$$$$$O$$$$$$$X",
"OO$$$$$$$$$+OOOX#$&&$$+OO+$+$$OXOO$$$$$$$$$+OOOX+$$$$$+$+$$%$$$.",
"OO$$$+$$%%+O$+$X#&&$$$$$$$+$$$+.OO$$$+$$%%+O$+$X+$$$$$$$$$%++$+.",
"O++$+$%%OOO$+$+.$&$$$$+$$+$+$$$XO++$+$%%OOO$+$+.O$+$$$$$$$%+$$X.",
"++$+$+OO+O$O$++.+$$$$O$$$$$$$$$.++$+$+OO+O$O$++.O+$+$$$$$%+$++..",
"+$+++OO$O$O$+$O.O+$OO$$$$$$$$+O.+$+++OO$O$O$+$O.OO+$+$$$%OO++X. ",
"....X.XXXXX.X..  .X.XXXXXXXX... ....X.XXXXX.X.. ....X.XXXXX.X.. "
};
