/* XPM */
static char *TILE_1F1678375611[] = {
/* columns rows colors chars-per-pixel */
"64 64 22 1 ",
"  c black",
". c #28221F",
"X c #206134",
"o c #377B36",
"O c #405638",
"+ c #383F40",
"@ c #4E595A",
"# c #5A7B48",
"$ c #616257",
"% c #536265",
"& c #5B6F73",
"* c #62797E",
"= c #65A117",
"- c #4E9129",
"; c #7E9154",
": c #7C9193",
"> c #888D82",
", c #89928C",
"< c #93968B",
"1 c #869A9C",
"2 c #9BACAA",
"3 c #A1A9A3",
/* pixels */
"23,<<;;;;;;;%@O  ..+.++@>>;;%@O.23,<<;;;;;;;%@O 2111***$$>;;%@O ",
"1#%%%;##%%%##%@.1>>>;;>>#%%%@%@.1#%%%;##%%%##%@.<#%%%%;*%%%%@%@.",
"*%%%;#%%%%##%%%+1#%%%;##%%%%%@%+*%%%;#%%%%##%%%+#%%%#;%%%%%%%@%+",
"*%%*%%#%###%%%O.1%%%;#%%%%%%%%%.*%%*%%#%###%%%O.;%%**%%%%%%%%%%.",
"*%#*%#%##%%%%%O+*%%*%%%%%%%%%%@.*%#*%#%##%%%%%O+;%;%%%%%%%%%%%@.",
"*%;%%%#%%%%%%O%+*%#*%#%%%%%%&O+.*%;%%%#%%%%%%O%+;;#%%%%%%%%%&O+.",
"*;%%%#%%%%@%@%%+*;#%#%#%%%%&OO++*;%%%#%%%%@%@%%+*;#%#%#%%%%&OO++",
"$*%%%%%%%%O%%%%+>;##%#%%%%&&OO+.$*%%%%%%%%O%%%%+>;##%#%%%%&&OO+.",
"$%%%%%%%%OO%%%%+>;#%##%%%&OO@O++$%%%%%%%%OO%%%%+>;#%##%%%&OO@O++",
"O%%%%%%%&O@%@%%+;#%%%%%@%O@%%@O+O%%%%%%%&O@%@%%+;#%%%%%@%O@%%@O+",
"OO%%%%%&O@%@%%%+#%%%%%@%@@%%%%O+OO%%%%%&O@%@%%%+#%%%%%@%@@%%%%O+",
"OO%%%%&O@%@%@%%+%%%%%@%@%%%%%%%+OO%%%%&O@%@%@%%+%%%%%@%@%%%%%%%+",
"O@%%%&O@%@%%%%%.%%%%@%@%%%%%%%%.O@%%%&O@%@%%%%%.%%%%@%@%%%%%%%%.",
"@%%&OOO%%%%%%%@.@%%%%%%%%%%%%%@.@%%&OOO%%%%%%%@.@%%%%%%%%%%%%%@.",
"@OOOOO@%%OO@%%O @OOO%%+%%OO@%XOoX-OOOO@%%OO@%%O.@OOO%%%%%OO@%%O ",
" ...+.+++++.+.  ....+.X+oX+.+-=X-==o+.+++++.+..  ...+.+++++.+.  ",
"2<#;;;;;;;;;%@O.:>#;;#.=X.O**O+.X.X+***$$OOOO@@ ::***O+OO@@@OOO ",
"1#%%%;##%%%##%@.:#%%*#o--=+##%@.+#%%%%;*%%OO@@%.>#%%%%O+@%%%%@O.",
"1%%%;#%%%%##%%%+*%%*#%Oo-oX#%%%+#%%%#;%%%%%%@%@.#%%*%%@O%%%%@%@.",
"1%%*%%%%###%#%O.*%*%%#%=oXO%%%O.;%%**%%%%%%%%@@.;%*%%%%O%%%%%@%.",
"*%#*%%%###%#%%O+*%%%%%%XO**%%%O+;%;%%%%%%%%%@%@+;*#%%%@%O%%%%%@+",
"*%;%%%%%#%#%%O%+O%%%%%%%%%*%%%%+;;#%%%%%%%%@%@O.##%#%%%@O%%%%%%.",
"*;%%%%%#%%%%@%%++O@%@%%%%@%%%%%+;#%%%%%%%%%%&OO+O%#%%%%%O%@%%%%+",
"$*%%%%%%%%%%%%%+O+OO%@%@@%@%%%%+;#%%#%#%%%%%&O%++##%%%%@@O%%%%%+",
"$%%%%%%%%%%%%%@+O@%%OOO@%%%%%%%+;%%###%%%%%&O@O+O++*%%%@%%@%%%&+",
"O%%%%%%%%%%%%@@+@%%%%%%O%%%%%%%+;%%##%%%%%%&OO%+OOOO*%@%%%%%%&O+",
"OO%%%%%%%%%@OOO+@%%%%%@%@%%&%%%.;%##%#%%%%%@O%O+O*:***%@%%%&&@O+",
"OO%%%@%%&&@O%@%+@%%%%%%%%%&@@%@.;##%#%%%%%@O%O%.*##%%%%%%%&@@%@.",
"O@@%@%&&OOO%@%@.O%@%%%%%%%&@%%+.%#%#%%@%%%O%@=@X*#%%%%%%%%%@%@@+",
"@@%@%@OO@O%O%@@.O@%@%%%%%&@%@@. @%%%%O%%%@O@%=o=@X%%%%%%%%%%%@+.",
"@%@@@OO%O%O%@%O.OO@%@%%%&OO@@+  O@%OO%%%@@O%@@-X=.%OO=%%%%%@+.. ",
"....+.+++++.+.. ....+.+++++.+.. ..+.+++++++.X-X-=X-o-Xo.++.. .  ",
"23,<<;;;;;;;%@O.2<#;;;;;;;;;%@O. 111***>>;#%-O..o-.oX.+@>>;;%@O ",
"1#%%%;##%%%##%@.1#%%%;##%%%##%@..>#%%%;;;#%%%%O =X>>;;>>#%%%@%@.",
"*%%%;#%%%%##%%%+1%%%;#%%%%##%%%+.>%%%####%%%%%Oo%#%%%;##%%%%%@%+",
"*%%*%%#%###%%%O.1%%*%%%%###%#%O.+>%%**%#%%%%%%O-O%%%;#%%%%%%%%%.",
"*%#*%#%##%%%%%O+*%#*%%%###%#%%O+.;%;%%#%#%%%@%=oO%%*%%%%%%%%%%@.",
"*%;%%%#%%%%%%O%+*%;%%%%%#%#%%O%++;;#%#%##%%@%%%XO%#*%#%%%%%%&O+.",
"*;%%%#%%%%@%@%%+*;%%%%%#%%%%@%%++>#%%%#%%%@%@%%+*;#%#%#%%%%&OO++",
"$*%%%%%%%%O%%%%+$*%%%%%%%%%%%%%+@>#%%%%%%@%@%%%+>;##%#%%%%&&OO+.",
"$%%%%%%%%OO%%%%+$%%%%%%%%%%%%%@+>#%%%%%%%%@%%%%+>;#%##%%%&OO@O++",
"O%%%%%%%&O@%@%%+O%%%%%%%%%%%%@@+>%%%%%%%&O@%%%O+;#%%%%%@%O@%%@O+",
"OO%%%%%&O@%@%%%o+O%%%%%%%%%@OOO+;%%%%%%&O@%%%%O+#%%%%%@%@@%%%%O+",
"OO%%%%&O@%@%@%%o+O%%%@%%&&@O%@%+;%%%%%&&O%%%%%@.%%%%%@%@%%%%%%%+",
"O@%%%&O@%@%%%%=-+@o%@%&&OOO%@%@.%@%%%&OO@%%%%%%+%%%%@%@%%%%%%%%.",
"@%%&OOO%%%%%%ooXXo%@%@OO@O%O%@@.@%@%%OOOO@%%%%%.@%%%%%%%%%%%%%@.",
"@OOOOO@%%OO@%%o=Xo@@@OO%-%O%@%O.O@%%@++++OO%%@O.@OOO%%%%%OO@%%O.",
"....+.+++++.X-=-=-oX+.X-=-=X-X. ..+...+.++++... ....+.+++++.+.. ",
"2<#;;;;;;;;;%o.X--+****.-o.o+@@ 2<#;;;;;;;;;%@O.:>#;;#O+OOO**@O.",
"1#%%%;##%%%##%@-.oOo%%;*OOOO@%O.1#%%%;##%%%##%@.:#%%*#%#+O*##%@.",
"1%%%;#%%%%##%%o+%Oo%#;%%%%%%%%O.1%%%;#%%%%##%%%+*%%*#%##+O:#%%%+",
"1%%*%%%%###%#%O.<%%**%%%%%%%%&O.1%%*%%%%###%#%O.*%*%%#%%*O*%%%O.",
"*%#*%%%###%#%%O+<%;%%%%%%%%%%OO+*%#*%%%###%#%%O+*%%%%%%%%**%%%OX",
"*%;%%%%%#%#%%O%+;;#%#%#%%%%%&OO.*%;%%%%%#%#%%O%+O%%%%%%%%%*%%%%o",
"-;%%%%%#%%%%@%%+;#%#%#%%%%%&OO@+*;%%%%%#%%%%@%%++O@%@%%%%@%%%%+o",
".O%%%%%%%%%%%%%+;#%%#%%%%%&O@%%+$*%%%%%%%%%%%%%+O+OO%@%@@%@%%@X=",
"XO%%%%%%%%%%%%@+;%%##%%%%&O@%%%+$%%%%%%%%%%%%%@+O@%%OOO@%%%%@@-=",
".%%%%%%%%%%%%@@+;%%#%%%%OO@%@%O+O%%%%%%%%%%%%@@+@%%%%%%O%%%%%+Xo",
"-O%%%%%%%%%@OOO+;%##%%@OO@%@%%O+OO%%%%%%%%%@OOO+@%%%%%@%@%%&%%.X",
"+O%%%@%%&&@O%@%+;##%%%%%%%@%%%@.OO%%%@%%&&@O%@%+@%%%%%%%%%&@@%@=",
"O@@%@%&&OOO%@%@.%#%%%%@%%@%@%%%+O@@%@%&&OOO%@%@.O%@%%%%%%%&@%%+-",
"@@%@%@OO@O%O%@@.@%%%%O%%%%%%%%%.@@%@%@OO@O%O%@@.O@%@%%%%%&@%@@.X",
"@%@@@OO%O%O%@%O.O@%OO%%%%%%%%@O.@%@@@OO%O%O%@%O.OO@%@%%%&OO@@+.X",
"....+.+++++.+..  .+.++++++++... ....+.+++++.+.. ....+.+++++.+.. "
};
