/* XPM */
static char *TILE_2A1678375768[] = {
/* columns rows colors chars-per-pixel */
"64 64 18 1 ",
"  c black",
". c #28221F",
"X c #383F40",
"o c #464D4F",
"O c #4E595A",
"+ c #616257",
"@ c #79735E",
"# c #536265",
"$ c #5B6F73",
"% c #666A62",
"& c #62797E",
"* c #7C9193",
"= c #888D82",
"- c #89928C",
"; c #93968B",
": c #869A9C",
"> c #9BACAA",
", c #A1A9A3",
/* pixels */
">,-;;@@@@@@@#Oo  ..X.XXO==@@#Oo.>,-;;@@@@@@@#Oo >:::&&&++=@@#Oo ",
":%###@%%###%%#O.:===@@==%###O#O.:%###@%%###%%#O.;%####@&####O#O.",
"&###@%####%%###X:%###@%%#####O#X&###@%####%%###X%###%@#######O#X",
"&##&##%#%%%###o.:###@%#########.&##&##%#%%%###o.@##&&##########.",
"&#%&#%#%%#####oX&##&##########O.&#%&#%#%%#####oX@#@###########O.",
"&#@###%######o#X&#%&#%######$oX.&#@###%######o#X@@%#########$oX.",
"&@###%####O#O##X&@%#%#%####$ooXX&@###%####O#O##X&@%#%#%####$ooXX",
"+&########o####X=@%%#%####$$ooX.+&########o####X=@%%#%####$$ooX.",
"+########oo####X=@%#%%###$ooOoXX+########oo####X=@%#%%###$ooOoXX",
"o#######$oO#O##X@%#####O#oO##OoXo#######$oO#O##X@%#####O#oO##OoX",
"oo#####$oO#O###X%#####O#OO####oXoo#####$oO#O###X%#####O#OO####oX",
"oo####$oO#O#O##X#####O#O#######Xoo####$oO#O#O##X#####O#O#######X",
"oO###$oO#O#####.####O#O########.oO###$oO#O#####.####O#O########.",
"O##$ooo#######O.O#############O.O##$ooo#######O.O#############O.",
"OoooooO##ooO##o Oooo#####ooO##o.OoooooO##ooO##o.Oooo#####ooO##o ",
" ...X.XXXXX.X.  ....X.XXXXX.X.. ....X.XXXXX.X..  ...X.XXXXX.X.  ",
">;%@@@@@@@@@#Oo.*=%@@%oXooo&&Oo.>:::&&&++ooooOO **&&&oXooOOOooo ",
":%###@%%###%%#O.*%##&%#%Xo&%%#O.;%####@&##ooOO#.=%####oXO####Oo.",
":###@%####%%###X&##&%#%%Xo*%###X%###%@######O#O.%##&##Oo####O#O.",
":##&####%%%#%#o.&#&##%##&o&###o.@##&&########OO.@#&####o#####O#.",
"&#%&###%%%#%##oX&########&&###oX@#@#########O#OX@&%###O#o#####OX",
"&#@#####%#%##o#Xo#########&####X@@%########O#Oo.%%#%###Oo######.",
"&@#####%####O##XXoO#O####O#####X@%##########$ooXo#%#####o#O####X",
"+&#############XoXoo#O#OO#O####X@%##%#%#####$o#XX%%####OOo#####X",
"+#############OXoO##oooO#######X@##%%%#####$oOoXoXX&###O##O###$X",
"o############OOXO######o#######X@##%%######$oo#Xoooo&#O######$oX",
"oo#########OoooXO#####O#O##$###.@#%%#%#####Oo#oXo&*&&&#O###$$OoX",
"oo###O##$$Oo#O#XO#########$OO#O.@%%#%#####Oo#o#.&%%#######$OO#O.",
"oOO#O#$$ooo#O#O.o#O#######$O##X.#%#%##O###o#O#OX&%#########O#OOX",
"OO#O#OooOo#o#OO.oO#O#####$O#OO. O####o###OoO#O#.O############OX.",
"O#OOOoo#o#o#O#o.ooO#O###$ooOOX  oO#oo###OOo#OOo.oO#oo######OX.. ",
"....X.XXXXX.X.. ....X.XXXXX.X.. ..X.XXXXXXXX..  ..X.XXXXXX.. .  ",
">,-;;@@@@@@@#Oo.>;%@@@@@@@@@#Oo. :::&&&==@%##OO. ..X.XXO==@@#Oo ",
":%###@%%###%%#O.:%###@%%###%%#O..=%###@@@%####o :===@@==%###O#O.",
"&###@%####%%###X:###@%####%%###X.=###%%%%#####o.:%###@%%#####O#X",
"&##&##%#%%%###o.:##&####%%%#%#o.X=##&&#%######o.:###@%#########.",
"&#%&#%#%%#####oX&#%&###%%%#%##oX.@#@##%#%###O##X&##&##########O.",
"&#@###%######o#X&#@#####%#%##o#XX@@%#%#%%##O###.&#%&#%######$oX.",
"&@###%####O#O##X&@#####%####O##XX=%###%###O#O##X&@%#%#%####$ooXX",
"+&########o####X+&#############XO=%######O#O###X=@%%#%####$$ooX.",
"+########oo####X+#############OX=%########O####X=@%#%%###$ooOoXX",
"o#######$oO#O##Xo############OOX=#######$oO###oX@%#####O#oO##OoX",
"oo#####$oO#O###Xoo#########OoooX@######$oO####oX%#####O#OO####oX",
"oo####$oO#O#O##Xoo###O##$$Oo#O#X@#####$$o#####O.#####O#O#######X",
"oO###$oO#O#####.oOO#O#$$ooo#O#O.#O###$ooO######X####O#O########.",
"O##$ooo#######O.OO#O#OooOo#o#OO.O#O##ooooO#####.O#############O.",
"OoooooO##ooO##o O#OOOoo#o#o#O#o.oO##OXXXXoo##Oo.Oooo#####ooO##o.",
"....X.XXXXX.X.. ....X.XXXXX.X.. ..X...X.XXXX... ....X.XXXXX.X.. ",
">;%@@@@@@@@@#Oo.>:&&&&&++ooooOO >;%@@@@@@@@@#Oo.*=%@@%oXooo&&Oo.",
":%###@%%###%%#O.,%####@&##ooO#o.:%###@%%###%%#O.*%##&%#%Xo&%%#O.",
":###@%####%%###X-###%@########o.:###@%####%%###X&##&%#%%Xo*%###X",
":##&####%%%#%#o.;##&&########$o.:##&####%%%#%#o.&#&##%##&o&###o.",
"&#%&###%%%#%##oX;#@##########ooX&#%&###%%%#%##oX&########&&###oX",
"&#@#####%#%##o#X@@%#%#%#####$oo.&#@#####%#%##o#Xo#########&####X",
"&@#####%####O##X@%#%#%#####$ooOX&@#####%####O##XXoO#O####O#####X",
"+&#############X@%##%#####$oO##X+&#############XoXoo#O#OO#O####X",
"+#############OX@##%%####$oO###X+#############OXoO##oooO#######X",
"o############OOX@##%####ooO#O#oXo############OOXO######o#######X",
"oo#########OoooX@#%%##OooO#O##oXoo#########OoooXO#####O#O##$###.",
"oo###O##$$Oo#O#X@%%#######O###O.oo###O##$$Oo#O#XO#########$OO#O.",
"oOO#O#$$ooo#O#O.#%####O##O#O###XoOO#O#$$ooo#O#O.o#O#######$O##X.",
"OO#O#OooOo#o#OO.O####o#########.OO#O#OooOo#o#OO.oO#O#####$O#OO..",
"O#OOOoo#o#o#O#o.oO#oo########Oo.O#OOOoo#o#o#O#o.ooO#O###$ooOOX. ",
"....X.XXXXX.X..  .X.XXXXXXXX... ....X.XXXXX.X.. ....X.XXXXX.X.. "
};
