NO ./images/bluestone.xpm
SO ./images/mossy.xpm
WE ./images/purplestone.xpm
EA ./images/redbrick.xpm
F 92,64,51
C 173,216,230     
      

        1111111111  111111111111
        10000000001   10000000001
        1011000011   10N00000001
        10010000001   10000000001
11111111101100000111110000000001
100000000011000001110111110111111
11111111111111011100000010001
       111101110101001000111
11111111111111111100000000001
1000000001    1  10000001001
1000000001       101011111111
11000001111111111 1111
11110111 1110101 101111111111
11111111 1111111 111111111111