NO ./images/bluestone.xpm
SO ./images/mossy.xpm
WE ./images/redbrick.xpm
EA ./images/purplestone.xpm
F 92,64,51
C 173,216,230 



111111111111111111111111111111
11111111100000000000000011111
100000000000000000111000100001
110000100000000000000000001111
100001111111000000010000111111
111111100000000000000000000001
111100000000001100000000000011
1000000000000000000E0000000001
110000000000011110000000000011
10000000000011100000000000001111
110000000000111000000000001111001
11000000000111100000000000011111
111111111111111111111111111111111
