/* XPM */
static char *TECH_0F1678374986[] = {
/* columns rows colors chars-per-pixel */
"64 64 13 1 ",
"  c black",
". c #141413",
"X c #1C1C1B",
"o c #2F1C17",
"O c #292A28",
"+ c #382B2F",
"@ c #4B3F38",
"# c #383F40",
"$ c #464D4F",
"% c #536265",
"& c #62797E",
"* c #9F7315",
"= c #C0A436",
/* pixels */
"                                                                ",
"$$$$$$$$$$$$$#$#$$$$$$$$$$#$#$#$$$$$$$$$$$$$$$$$$$$$$$$$$$$#$#$$",
"################################################################",
"################################################################",
"################################################################",
"################################################################",
"########+#######################################################",
"#######+.+######################################################",
"$$$$$$$@@@$$$$$$$$$$$$$$$$$$$$$$$$$$$$$$$$$$$$$$$$$$$$$$$$$$$$$$",
"#######+++######################################################",
"$$$$$$$@@$$$$$$$$$$$$$$$$$$$$$$$$$$$$$$$$$$$$$$$$$$$$$$$$$$$$$$$",
"$$$$$$$@@@$$$@$$$$$$$$$$$$$$$$$$$$$$$$$$$$$$$$$$$$$$$$$$$$$$$$$$",
"$$$$$$$@@$$$@+@$$$$$$$$$$$$$$$$$$$$$$$$$$$$$$$$$$$$$$$$$$$$$$$$$",
"$$$$$$$@@$$$@@@$$$$$$$$$$$$$$$$$$$$$$$$$$$$$$$$$$$$$$$$$$$$$$$$$",
"$$$$$$$$@$$$$@@$$$$$$$$$$$$$$$$$$$$$$$$$$$$$$$$$$$$$$$$$$$$$$$$$",
"$$$$$$$@@$$$$@$$$$$$$$$$$$$$$$$$$$$$$$$$$$$$$$$$$$$$$$$$$$$$$$$$",
"$$$$$$$$@$$$$$@$$$$$$$$$$$$$$$$$$$$$$$$$$$$$$$$$$$$$$$$$$$$$$$$$",
"$$$$$$$$@$$$$@$$$$$$$$$$$$$$$$$$$$$$$$$$$$$$$$$$$$$$$$$$$$$$$$$$",
"$$$$$$$$$$$$$$$$$$$$$$$$$$$$$$$$$$$$$$$$$$$$$$$$$$$$$$$$$$$$$$$$",
"$$$$$$$$@$$$$$$$$$$$$$$$$$$$$$$$$$$$$$$$$$$$$$$$$$$$$$$$$$$$#%$$",
"$$$$$$$$$$$$$$$$$$$$$$$$$$$$$$$$$$$$$$$$$$$$$$$$$$$$$$$$$$$#&$$$",
"$$$$$$$$$$$$$$$$$$$$$$$$$$$$$$$$$$$$$$$$$$$$$$$$$$$$$$$$$$$%$$$$",
"$$$$$$$$$$$$$$$$$$$$$$$$$$$$$$$$$$$$$$$$$$$$$$$$$$$$$$$$$#$$$$$$",
"$$$$$$$$$$$$$$$$$$$$$$$$$$$$$$$$$$$$$$$$$$$$$$$$$$$$$$#$#$$$$$$$",
"$$$$$$$$$$$$$$$$$$$$$$$$$$$$$$$$$$$$$$$$$$$$$$$$$$$$$#%#$#%$$$$$",
"$$$$$$$$$$$$$$$$$$$$$$$$$$$$$$$$$$$$$$$$$$$$$$$$$$$$#&#$#&$$$$$$",
"$$$$$$$$$$$$$$$$$$$$$$$$$$$$$$$$$$$$$$$$$$$$$$$$$$$#&$$#%$$$$$$$",
"$$$$$$$$$$$$$$$$$$$$$$$$$$$$$$$$$$$$$$$$$$$$$$$$$$$%$$#$$$$$$$$$",
"****$*****$*$**$*$***$$$*************$$$**$$*$***$=**$*******$=*",
"***$***$***$********$*$$************$*$*$*$*$***$=*******$**$=**",
"**$***$*$***$******$*$*$*$***********$*$*$*$***$******$*$***=***",
"*$$$*$$$*$*$********$*$*$*$*$*********$*$$$**********$*$$$******",
"$$$$$$$$$$$$$$$$$$$$$$$$$$$$$$$$$$$$$$$$$$$$$$$$$$$$$$$$$$$$$$$$",
"$$$$$$$$$$$$$$$$$$$$$$$$$$$$$$$$$$$$$$$$$$$$$$$$$$$$$$$$$$$$$$$$",
"$$$$$$$$$$$$$$$$$$$$$$$$$$$$$$$$$$$$$$$$$$$$$$$$$$$$$$$$$$$$$$$$",
"$$$$$$$$$$$$$$$$$$$$$$$$$$$$$$$$$$$$$$$$$$$$$$$$$$$$$$$$$$$$$$$$",
"$$$$$$$$$$$$$$$$$$$$$$$$$$$$$$$$$$$$$$$$$$$$$$$$$$$$$$$$$$$$$$$$",
"&&&&&&&&&&&&&&&&&&&&&&&&&&&&$&$&&&&$&&&&&&&$&&&&&&&$&$&$&$&&&&&&",
"                                                                ",
"                                                                ",
"X. .X...X. .X...X. .X...X. .X...X. .X...X. .X...X. .X...X. .X...",
"O. OOX.OO. OOX.OO. OOX.OO. OOX.OO. OOX.OO. OOX.OO. OOX.OO. OOX.O",
"O. OOXXOO. OOXXOO. OOXXOO. OOXXOO. OOXXOO. OOXXOO. OOXXOO. OOXXO",
"O. OOXXOO. OOXXOO. OOXXOO. OOXXOO. OOXXOO. OOXXOO. OOXXOO. OOXXO",
"OX.OOXXOOX.OOXXOOX.OOXXOOX.OOXXOOX.OOXXOOX.OOXXOOX.OOXXOOX.OOXXO",
"O. OOXXOO. OOXXOO. OOXXOO. OOXXOO. OOXXOO. OOXXOO. OOXXOO. OOXXO",
"OX.OOXXOOX.OOXXOOX.OOXXOOX.OOXXOOX.OOXXOOX.OOXXOOX.OOXXOOX.OOXXO",
"OX OOXXOOX OOXXOOX OOXXOOX OOXXOOX OOXXOOX OOXXOOX OOXXOOX OOXXO",
"OX.OOXXOOX.OOXXOOX.OOXXOOX.OOXXOOX.OOXXOOX.OOXXOOX.OOXXOOX.OOXXO",
"OX.OOXXOOX.OOXXOOX.OOXXOOX.OOXXOOX.OOXXOOX.OOXXOOX.OOXXOOX.OOXXO",
"O..OOXXOO..OXXXOO..OOXXOO..OXXXOO..OOXXOO..OXXXOO..OOXXOO..OXXXO",
"OX.OOXXOOX.OOXXOOX.OOXXOOX.OOXXOOX.OOXXOOX.OOXXOOX.OOXXOOX.OOXXO",
"X. OXXXOX. OXXXOX. OXXXOX. OXXXOX. OXXXOX. OXXXOX. OXXXOX. OXXXO",
"O..XOXXOO..XOXXOO..XOXXOO..XOXXOO..XOXXOO..XOXXOO..XOXXOO..XOXXO",
"X. OXX.OX. OXX.OX. OXX.OX. OXX.OX. OXX.OX. OXX.OX. OXX.OX. OXX.O",
"X  XX. XX  XX. XX  XX. XX  XX. XX  XX. XX  XX. XX  XX. XX  XX. X",
"&&&&&&&&&%&&&&%&%&%&%&%%%%%%&%&%&%&&&&&&&&&&&&&&&&&&&&&&&%&&&&%&",
"$$$$$$$$#$$$$$$$$$$$$$$$$#$$$$$$$$$$$$$#$#$$$$$$#$#$$$$$#$$$$$$$",
"$#$$$$$#$$$$$$$$$$$$$$$##$$$$$$$$$$$$$$$#$$$$$$$$#$$$$$#$$$$$$$$",
"#$$&#$$$$$$&#$$$$$$&#$$#$$$&#$$$$$$&#$$#$$$&#$$$#$$&#$$$$$$&#$$$",
"$$+##$$$$$+##$$$$$+##$#$#$+##$$$$$+##$$$$$+##$$#$$+##$$$$$+##$$#",
"#$++$$$$$$++$$$$$$++$$$#$$++$$$$$$++$$$$$$++$$##$$++$$$$$$++$$#$",
"$$$$$$$$$$$$$$$$$$$$$$#$$$$$$$$$$$$$#$$$$$$$$$#$$$$$$$$$$$$$$#$#",
"+oooooo+o+o+++++++o+o+.+.+....+.++++++++o+o++o+o+oooooo+o+o+++++"
};
