/* XPM */
static char *a26e68b18a734f97bc78ba55b06749b0RWZNXwPT3BZ8ymeP[] = {
/* columns rows colors chars-per-pixel */
"64 64 20 1 ",
"  c black",
". c #141413",
"X c #1C1C1B",
"o c #2F1C17",
"O c #28221F",
"+ c #292A28",
"@ c #382B2F",
"# c #4B3F38",
"$ c #383F40",
"% c #2F5075",
"& c #464D4F",
"* c #536265",
"= c #62797E",
"- c #5594B7",
"; c #009DEB",
": c #0095F6",
"> c #00C5F4",
", c #09E4FC",
"< c #C6F6FF",
"1 c #F5F9ED",
/* pixels */
"                                                                ",
"&&&&&&&&&&&&&$&$&$&$$$. &&&&&&$&$&$&$$$$  $$&$&$&&&&&&&&&&&$&$&&",
"$$$$$$$$$$$$$$$$$$$$$$. &$$$$$$$$$$$$$$$  $$$$$$$$$$$$$$$$$$$$$$",
"$$$$$$$$$$$$$$$$$$$$$$. &$=$$====&$$$=$$  $$$$$$$$$$$$$$$$$$$$$$",
"$$$$$$$$$$$$$$$$@%%$$$. &@$$=@@@@@@$@$$$  $$@%%$$$$$$$$$$$$$$$$$",
"$$$$$$$$$$$$$$$$@%-$$$. &$$=@@@@@@@@&$$$ .$$@-%$$$$$$$$$$$$$$$$$",
"$$$$$$$$@$$$$$$$@@$$$$. &$=@@@:>>:@@@&$$. $$@@@$$$$$$$$$$$$$$$$$",
"$$$$$$$@.@$$$$$$$$$$$$. &$=@@:>>>>:@@=$$ .$$$@@$$$$$$$$$$$$$$$$$",
"&&&&&&&###&&&&&&&&&&&&O.&$=@@>><<>>@@=$$. &&&##&&&&&&&&&&&&&&&&&",
"$$$$$$$@@@$$$$&$&$$$$$. &$=@@>>11>>@@=$$ .$$$@$$$$$$&$&$&$$$$$$$",
"&&&&&&&##&&&&&&&&&&&&&O.=&-$$,,11,,$$-&&. &&&&#&&&&&&&&&&&&&&&&&",
"&&&&&&&###&&&&&&&&&&&&. &$=@@>>11>>@@=$$ O&&&#&&&&&&&&&&&&&&&&&&",
"&&&&&&&##&&&&&&&&&&&&&O.=&-$$,,11,,$$-&&O.&&&&&&&&&&&&&&&&&&&&&&",
"&&&&&&&##&&&&&&&&&&&&&O.=&-$$,,11,,$$-&&.O&&&&&&&&&&&&&&&&&&&&&&",
"&&&&&&&&#&&&&&&&&&&&&&O.=&-$$,,1<,,$$-&&O.&&&&&&&&&&&&&&&&&&&&&&",
"&&&&&&&##&&&&&&&&&&&&&O.=&-$$,,<1,,$$&&&.O&&&&&&&&&&&&&&&&&&&&&&",
"&&&&&&&&#&&&&&&&&&&&&&O.=&-$$,,11,,$$-&&O.&&&&&&&&&&&&&&&&&&&&&&",
"&&&&&&&&#&&&&&&&&&&&&&..=&-$$,,11,,$$&&&.O&&&&&&&&&&&&&&&&&&&&&&",
"&&&&&&&&&&&&&&&&&&&&&&O.=&-$$,,11,,$$-&&OO&&&&&&&&&&&&&&&&&&&&&&",
"&&&&&&&&#&&&&&&&&&&&&&..*&-$$,,11,,$$-&&.O&&&&&&&&&&&&&&&&&&$*&&",
"&&&&&&&&&&&&&&&&&&&&&&O.=&&$$,,11,,$$-&&OO&&&&&&&$&&&&&&&&&$=&&&",
"&&&&&&&&&&&&&&&&&&&&&&..*&-$$,,11,,$$-&&.O&&&&&&$-&&&&&&&&&*&&&&",
"&&&&&&&&&&&&&&&&&&&&&&O.=&&$$,,11,,$$-&&OO&&&&&&-&&&&&&&&$&&&&&&",
"&&&&&&&&&&&&&&&&&&&&&&..*&-$$,,11,,$$-&&.O&&&&&%&&&&&&$&$&&&&&&&",
"&&&&&&&&&&&&&&&&&&&&&&..*&-$$,,11,,$$-&&.O&&&&&&&&&&&$*$&$*&&&&&",
"&&&&&&&&&&&&&&&&&&&&&&..*&-$$,,1<,,$$-&&.O&&&&&&&&&&$=$&$=&&&&&&",
"&&&&&&&&&&&&&&&&&&&&&&..*&-$$,,<1,,$$-&&.O&&&&&&&&&$=&&$*&&&&&&&",
"&&&$&&&&&&&&&&&&&&&&&&..*&-$$,,1<,,$$-&&OO&&&&&&&&&*&&$&&&&&&&&&",
"&&&&$&&&&&&&&&&&&&&&&&..&&-$$,,<1,,$$-&&.O&&&&&&&&&&&&&&&&&&&&&&",
"&&&$$&&&&&&&&&&&&&&&&&..*&-$$,,11,,$$-&&OO&&&&&&&&&&&&&&&&&&&&&&",
"&&$$$&&&&&&&&&&&&&&&&&..&&=$$,,11,,$$-&&.O&&&&&&&&&&&&&&&&&&&&&&",
"&&$$&&&&&&&&&&&&&&&&&&.O*&-$$,,<<,,$$-&&OO&&&&&&&&&&&&&&&&&&&&&&",
"&&$$$&&&&&&&&&&&&&&&&&O.&&=$$;,,,,;$$-&&OO&&&&&&&&&&&&&&&&&&&&&&",
"&&&$&&&&&&&&&&&&@%-&&&.O&&=$$$;,,;$$$-&&OO&&@-%&&&&&&&&&&&&&&&&&",
"&&&&$&&&&&&&&&&&@%%&&&O.&&&=$$$$$$$$-&&&OO&&@%%&&&&&&&&&&&&&&&&&",
"&&&&&&&&&&&&&&&&@@&&&&.O&&&&=$$$$$$-&&&&OO&&@@&&&&&&&&&&&&&&&&&&",
"&&&&&&&&&&&&&&&&&&&&&&OO&&%&&=-=---&&%&&OO&&&&&&&&&&&&&&&&&&&&&&",
"===================&=&OO&@&&&&&&&&&&@&&&OO&=&======&=&=&=&======",
"                       O&&&&&&&&&&&&&&&&O                       ",
"                        &&==========&=&&                        ",
"X. .X...X. .X...X. .X.                     .X...X. .X...X. .X...",
"+. ++X.++. ++X.++. ++X.                  . ++X.++. ++X.++. ++X.+",
"+. ++XX++. ++XX++. ++XX+.. .X...X. .X...X. ++XX++. ++XX++. ++XX+",
"+. ++XX++. ++XX++. ++XX++. ++XX++. ++XX++. ++XX++. ++XX++. ++XX+",
"+X.++XX++X.++XX++X.++XX++X.++XX++X.++XX++X.++XX++X.++XX++X.++XX+",
"+. ++XX++. ++XX++. ++XX++. ++XX++. ++XX++. ++XX++. ++XX++. ++XX+",
"+X.++XX++X.++XX++X.++XX++X.++XX++X.++XX++X.++XX++X.++XX++X.++XX+",
"+X ++XX++X ++XX++X ++XX++X ++XX++X ++XX++X ++XX++X ++XX++X ++XX+",
"+X.++XX++X.++XX++X.++XX++X.++XX++X.++XX++X.++XX++X.++XX++X.++XX+",
"+X.++XX++X.++XX++X.++XX++X.++XX++X.++XX++X.++XX++X.++XX++X.++XX+",
"+..++XX++..+XXX++..++XX++..+XXX++..++XX++..+XXX++..++XX++..+XXX+",
"+X.++XX++X.++XX++X.++XX++X.++XX++X.++XX++X.++XX++X.++XX++X.++XX+",
"X. +XXX+X. +XXX+X. +XXX+X. +XXX+X. +XXX+X. +XXX+X. +XXX+X. +XXX+",
"+..X+XX++..X+XX++..X+XX++..X+XX++..X+XX++..X+XX++..X+XX++..X+XX+",
"X. +XX.+X. +XX.+X. +XX.+X. +XX.+X. +XX.+X. +XX.+X. +XX.+X. +XX.+",
"X  XX. XX  XX. XX  XX. XX  XX. XX  XX. XX  XX. XX  XX. XX  XX. X",
"=========*=-=-*-*----------------------------=-=-=-======*====*=",
"&&&&&&&&$&&&&&&&&&&&&&&&&$&&&&&&$&&&&&&&$&&&&&&&$&$&&&&&$&&&&&&&",
"&$&&&&&$&&&&&&&&&&&&&&&$$&&&&&&&&&&&&&&###&&&&&&&$&&&&&$&&&&&&&&",
"$&&=$&&&&&&=$&&&&&&%$&&$&&#%$&&&&&&%$&#&#&&%$&&&$&&=$&&&&&&=$&&&",
"&&@$$&&&&&@$$&&&&&@$$&$&$&@$$&&$&&@$$&&#&&@$$&&$&&@$$&&&&&@$$&&$",
"$&@@&&&&&&@@&&&&&&@@&&&$&&@@#&&&&&@@&&#&&&@@&&$$&&@@&&&&&&@@&&$&",
"&&&&&&&&&&&&&&&&&&&&&&$&&&&##&&&&&&&&#&&&&&&&&$&&&&&&&&&&&&&&$&$",
"@oooooo@o@o@@@@@@@o@o@.@.@....@.@@@@@@@@o@o@@o@o@oooooo@o@o@@@@@"
};
