/* XPM */
static char *_fd5acfd044c4f1fe576ca57181367a1vF6mJ8nDoPVLKspv[] = {
/* columns rows colors chars-per-pixel */
"64 64 20 1 ",
"  c black",
". c #141413",
"X c #1C1C1B",
"o c #191B1D",
"O c #2F1C17",
"+ c #0C3A00",
"@ c #28221F",
"# c #242A2B",
"$ c #292A28",
"% c #382B2F",
"& c #4B3F38",
"* c #246200",
"= c #383F40",
"- c #334043",
"; c #464D4F",
": c #536265",
"> c #62797E",
", c #238F00",
"< c #35AE00",
"1 c #889C9E",
/* pixels */
"                                                                ",
";;=;===. ;;;;;;;;;;;;;;;;;;;;;;;;@;;;=;=;;;;;;;;;;=;===. ;;;;;;;",
"=======. ;====================;==@=====================. ;======",
"=======. ;====================:==%=====================. ;======",
"==%>;==. ;=%>;================;==@===============%>;===. ;%>;===",
"==%;;==. ;=%;;================:==%===============%;;===. ;%;;%==",
"==%%===. ;=%%=================:==%===============%%====. ;%%%===",
"=======. ;====================:==%=====================. ;=%%===",
";;;;;;;@.>;;;;;;;;;;;;;;;;;;;;>;;=;;;;;;;;;;;;;;;;;;;;;@.>;&&;;;",
"=======. ;====================:==%=====================. ;=%%===",
";;;;;;;@.>;;;;;;;;;;;;;;;;;;;;>;;=;;;;;;;;;;;;;;;;;;;;;@.>;&&;;;",
";;;;;;;. >;;;;;;;;;;;;;;;;;;;;>;;=;;;;;;;;;;;;;;;;;;;;;. >;&&;;;",
";;;;;;;@.>;;;;;;;;;;;;;;;;;;;;>;;=;;;;;;;;;;;;;;;;;;;;;@.>;;&;;;",
";;;;;;;@.>;;;;:11111>1>>>>>>>>;;;;:>>>>>:>:::::::;;;;;;@.>;&;;;;",
";;;;;;;@.>;;;:1;;;;;;;;;;;;;;;;;;;;;;;;;;;;;;;;;;;;;;;;@.>;;&;;;",
";;;;;;;@.>;;;1;>;;;;;;;;;;;;;;;;;;;;;;;;;;;;;;;;>;=;;;;@.>;&;;;;",
";;;;;;;..:;;;1%;;=%%%%%%%%%=%=%=======;=;=;;;;;%;;=;;;;..:;;;;;;",
";;;;;;;@.>;;;1;;=.............................$;;;=;;;;@.>;;;;;;",
";;;;;;;..:;;;1;;%.>-#####o#oooo.o.o............;;;=;;;;..:;;;;;;",
";;;;;;;@.>;;;1;;%.-#oooooooo.o.o...............:;;=;;;;@.>;;;;;;",
";;;;;;;..:;;;>;;%.#oooooo.o.o..................:;;=;;;;..:;;;;;;",
";;;;;;;@.:;;;1;;%.#ooo.o.o.................... :;;=;;;;@.:;;;;;;",
";;;;;;;X.:;;;>;;%.#oo.o........................:;;=;;;;X.:;;;;;;",
";;;;;;;X.:;;;>;;%.oo.o........................ :;;=;;;;X.:;;;;;;",
";;;;;;;XX:;;;>;;%.#oo......................... >;;=;;;;XX:;;;;;;",
";;;;;;;X.:;;;>;;%.oo.......................... :;;=;;;;X.:;;;;;;",
";;;;;;;.X:;;;>;;%.o........................... >;;=;;;;.X:;;;;;;",
";;;;;;;X.:;;;>;;=..o.......................... >;;=;;;;X.:;;;;;;",
";;;;;;;..:;;;>;;%.o........................... >;;=;;;;..:;;;;;;",
";;;;;;;..:;;;:;;=..o.......................... >;;=;;;;..:;;;;;;",
";;;;;;;.@:;;;>;;=.o........................... >;;=;;;;.@:;;;;;;",
";;;;;;;@.:;;;:;;=............................. >;;%;;;;@.:;;;;;;",
";;;;;;;.@:;;;:;;=.o........................... 1;;=;;;;.@:;;;;;;",
";;;;;;;@.:;;;:;;=............................. >;;%;;;;@.:;;;;;;",
";;;;;;;.@:;;;:;;;..,.<+,.<.+<.<*.,.+,*.+.<.... 1;;%;;;;.@:;;;;;;",
";;;;;;;@@:;;;:;;=..<.+,*.+.<*.<,.,.*.<.,+,.... >;;%;;;;@@:;;;;;;",
";;;;;;;@@:;;;:;;;............................. 1;;%;;;;@.:;;;;;;",
">>>>;>;@.:;;;:;;;..<.,+.<.+,.*.<.<............ 1;;%;;;;..:;;;;;;",
"         :;;;:;;;..+*<,.,.*,.<,+.,............ 1;;%;;;;..       ",
"         :;;;:;;;............................  1;;%;;;;.$       ",
"X. .X....:;;;:;;;$..... .                     $>;;%;;;;... .X...",
"$. $$X.$.:;;;:;;;;;:;:;::::::::::>:>>>>>>11111>;;;%;;;;.$. $$X.$",
"$. $$XX$X:;;;:;>;;;;;;;;;;;;;;;;;;;;;;;;;;;;;;;;>;%;;;;.$. $$XX$",
"$. $$XX$.:;;;;%;;;;;;;;;;;;;;;;;;;;;;;;;;;;;;;;%;%=;;;;.$. $$XX$",
"$X.$$XX$X;;;;;;==========%=%=%%%%%%%%%%%%%%%%%%%%=;;;;;.$X.$$XX$",
"$. $$XX$X:;;;;;;;;;;;;;;;;;;;;;;;;;;;;;;;;;;;;;;;;;;;;; $. $$XX$",
"$X.$$XX$X:;;;;;;;;;;;;;;;;;;;;;;;;;;;;;;;;;;;;;;;;;;;;;.$X.$$XX$",
"$X $$XX$X>;;;;;;;;;;;;;;;;;;;;;;;;;;;;;;;;;;;;;;;;;;;;; $X $$XX$",
"$X.$$XX$X>>>>>>>>;>;>;>>>>>>>>>>>>>>>>>>>;>;>>>>>>;>;;; $X.$$XX$",
"$X.$$XX$X                                               $X.$$XX$",
"$..$$XX$X. .X...X. .X...X. .X...X. .X...X. .X...X. .X...$..$$XX$",
"$X.$$XX$$. $$X.$$. $$X.$$. $$X.$$. $$X.$$. $$X.$$. $$X.$$X.$$XX$",
"X. $XXX$$. $$XX$$. $$XX$$. $$XX$$. $$XX$$. $$XX$$. $$XX$X. $XXX$",
"$..X$XX$$. $$XX$$. $$XX$$. $$XX$$. $$XX$$. $$XX$$. $$XX$$..X$XX$",
"X. $XX.$X. $XX.$X. $XX.$X. $XX.$X. $XX.$X. $XX.$X. $XX.$X. $XX.$",
"X  XX. XX  XX. XX  XX. XX  XX. XX  XX. XX  XX. XX  XX. XX  XX. X",
">>>>>>>>>:>>>>:>:>:>:>::::::>:>:>:>>>>>>>>>>>>>>>>>>>>>>>:>>>>:>",
";;;;;;;;=;;;;;;;;;;;;;;;;=;;;;;;;;;;;;;=;=;;;;;;=;=;;;;;=;;;;;;;",
";=;;;;;=;;;;;;;;;;;;;;;==;;;;;;;;;;;;;;;=;;;;;;;;=;;;;;=;;;;;;;;",
"=;;>=;;;;;;>=;;;;;;>=;;=;;;>=;;;;;;>=;;=;;;>=;;;=;;>=;;;;;;>=;;;",
";;%==;;;;;%==;;;;;%==;=;=;%==;;;;;%==;;;;;%==;;=;;%==;;;;;%==;;=",
"=;%%;;;;;;%%;;;;;;%%;;;=;;%%;;;;;;%%;;;;;;%%;;==;;%%;;;;;;%%;;=;",
";;;;;;;;;;;;;;;;;;;;;;=;;;;;;;;;;;;;=;;;;;;;;;=;;;;;;;;;;;;;;=;=",
"%OOOOOO%O%O%%%%%%%O%O%.%.%....%.%%%%%%%%O%O%%O%O%OOOOOO%O%O%%%%%"
};
