/* XPM */
static char *_2ef41390aa24ebdf8ff65d73d86ffebWpRlaTOpWgaEGD0A[] = {
/* columns rows colors chars-per-pixel */
"64 64 17 1 ",
"  c black",
". c #141413",
"X c #1C1C1B",
"o c #251713",
"O c #2F1C17",
"+ c #28221F",
"@ c #292A28",
"# c #382B2F",
"$ c #5B1A10",
"% c #4B3F38",
"& c #383F40",
"* c #464D4F",
"= c #536265",
"- c #62797E",
"; c #BC240D",
": c #866D0E",
"> c #D0B702",
/* pixels */
"                                                                ",
"*************&*&*&*&&&. ******&*&*&*&&&&  &&*&*&***********&*&**",
"&&&&&&&&&&&&&&&&&&&&&&. *&&&&&&&&&&&&&&&  &&&&&&&&&&&&&&&&&&&&&&",
"&&&&&&&&&&&&&&&&&&&&&&. *&-&&&&&&&&&&-&&  &&&&&&&&&&&&&&&&&&&&&&",
"&&&&&&&&&&&&&&&&#-*&&&. *#&&&&&&&&&&#&&&  &&#-*&&&&&&&&&&&&&&&&&",
"&&&&&&&&&&&&&&&&#**&&&. *&&&&&&&&&&&&&&& .&&#**&&&&&&&&&&&&&&&&&",
"&&&&&&&&#&&&&&&&##&&&&. *&&&&&&&&&&&&&&&. &&###&&&&&&&&&&&&&&&&&",
"&&&&&&&#.#&&&&&&&&&&&&. *&&&&&&&&&&&&&&& .&&&##&&&&&&&&&&&&&&&&&",
"*******%%%************+.*&&&&&&&&&&&&&&&. ***%%*****************",
"&&&&&&&###&&&&*&*&&&&&. *&&&&&&&&&&&&&&& .&&&#&&&&&&*&*&*&&&&&&&",
"*******%%*************+.-***************. ****%*****************",
"*******%%%************. *&&&&&&&*&*&&*&& +***%******************",
"*******%%*************+.-***************+.**********************",
"*******%%*************+.-***************.+**********************",
"********%*************+.-***************+.**********************",
"*******%%*************+.-***************.+**********************",
"********%*************+.-***************+.**********************",
"********%*************..-***************.+**********************",
"**********************+.-****%%*********++**********************",
"********%*************..=****%%*********.+**********************",
"**********************+.-****%**********++**********&*&*********",
"**********************..=*****%*********.+*********&*&**********",
"**********************+.-****%**********++******&&&*&***********",
"**********************..=**************&.+***&&##=**************",
"**********************..=**************.+&&&##-=****************",
"**********************..=**************.+=--=*******************",
"**********************..=**************.+***********************",
"***&******************..=**************&+&**********************",
"****&*****************..****************.+**********************",
"***&&*****************..=***************++**********************",
"**&&&*****************..****************.+**********************",
"**&&******************.+=***************++**********************",
"**&&&*******=&********+.****************++**********************",
"***&*******=&***#-&***.+****************++**#-&*****************",
"****&****=- &***#&&***+.****************++**#&&*****************",
"*******=-   =***##****.+****************++**##******************",
"****=--    o ==*******++**-**********-**++**********************",
"----   o . o   ----*-*++*#**********#***++*-*------*-*-*-*------",
"    o  o.. $ o         +****************+                       ",
"    o. :.. $.o          **----------*-**                        ",
"X. .$X :.. ;.: .X. .X.                     .X...X. .X...X. .X...",
"@. .$X >.. ;.: @@. @@X.                  . @@X.@@. @@X.@@. @@X.@",
"@. .;X.>...;.> @@. @@XX@.. .X...X. .X...X. @@XX@@. @@XX@@. @@XX@",
"@. .;X.>o. ;.>.@@. @@XX@@. @@XX@@. @@XX@@. @@XX@@. @@XX@@. @@XX@",
"@X..;XX:>o.; :X@@X.@@XX@@X.@@XX@@X.@@XX@@X.@@XX@@X.@@XX@@X.@@XX@",
"@. .;XX :>:;: X@@. @@XX@@. @@XX@@. @@XX@@. @@XX@@. @@XX@@. @@XX@",
"@X.@ ;X@   ; XX@@X.@@XX@@X.@@XX@@X.@@XX@@X.@@XX@@X.@@XX@@X.@@XX@",
"@X @.;X@@X.;.XX@@X @@XX@@X @@XX@@X @@XX@@X @@XX@@X @@XX@@X @@XX@",
"@X.@@ ;@X.; XXX@@X.@@XX@@X.@@XX@@X.@@XX@@X.@@XX@@X.@@XX@@X.@@XX@",
"@X.@@X ;;; .@XX@@X.@@XX@@X.@@XX@@X.@@XX@@X.@@XX@@X.@@XX@@X.@@XX@",
"@..@@XX.  .@XXX@@..@@XX@@..@XXX@@..@@XX@@..@XXX@@..@@XX@@..@XXX@",
"@X.@@XX@@X.@@XX@@X.@@XX@@X.@@XX@@X.@@XX@@X.@@XX@@X.@@XX@@X.@@XX@",
"X. @XXX@X. @XXX@X. @XXX@X. @XXX@X. @XXX@X. @XXX@X. @XXX@X. @XXX@",
"@..X@XX@@..X@XX@@..X@XX@@..X@XX@@..X@XX@@..X@XX@@..X@XX@@..X@XX@",
"X. @XX.@X. @XX.@X. @XX.@X. @XX.@X. @XX.@X. @XX.@X. @XX.@X. @XX.@",
"X  XX. XX  XX. XX  XX. XX  XX. XX  XX. XX  XX. XX  XX. XX  XX. X",
"---------=----=-=-=-=-======-=-=-=-----------------------=----=-",
"********&****************&******&*******&*******&*&*****&*******",
"*&*****&***************&&**************%%%*******&*****&********",
"&**-&******-&******-&**&**%-&******-&*%*%**-&***&**-&******-&***",
"**#&&*****#&&*****#&&*&*&*#&&**&**#&&**%**#&&**&**#&&*****#&&**&",
"&*##******##******##***&**##%*****##**%***##**&&**##******##**&*",
"**********************&****%%********%********&**************&*&",
"#OOOOOO#O#O#######O#O#.#.#....#.########O#O##O#O#OOOOOO#O#O#####"
};
