/* XPM */
static char *TECH_4C1678375213[] = {
/* columns rows colors chars-per-pixel */
"64 64 19 1 ",
"  c black",
". c #141413",
"X c #1C1C1B",
"o c #2F1C17",
"O c #28221F",
"+ c #292A28",
"@ c #382B2F",
"# c #383F40",
"$ c #464D4F",
"% c #796F47",
"& c #536265",
"* c #62797E",
"= c #F78300",
"- c #FF992C",
"; c #FFB62C",
": c #FFD02C",
"> c #FFEC24",
", c #BAB77A",
"< c #F5F9ED",
/* pixels */
"                                                                ",
"$$$$$$$$$$$$$#$#$#$###. $$$$$$#$#$#$####  ##$#$#$$$$$$$$$$$#$#$$",
"######################. $###############  ######################",
"######################. $#*##****$###*##  ######################",
"################@%%###. $@##*@@@@@@#@###  ##@%%#################",
"################@%,###. $##*@@@@@@@@$### .##@,%#################",
"################@@####. $#*@@@=;;=@@@$##. ##@###################",
"######################. $#*@@=;;;;=@@*## .######################",
"$$$$$$$$$$$$$$$$$$$$$$O.$#*@@;;>>;;@@*##. $$$$$$$$$$$$$$$$$$$$$$",
"######################. $#*@@;;<<;;@@*## .######################",
"$$$$$$$$$$$$$$$$$$$$$$O.*$,##::<<::##,$$. $$$$$$$$$$$$$$$$$$$$$$",
"$$$$$$$$$$$$$$$$$$$$$$. $#*@@;;<<;;@@*## O$$$$$$$$$$$$$$$$$$$$$$",
"$$$$$$$$$$$$$$$$$$$$$$O.*$,##::<<::##,$$O.$$$$$$$$$$$$$$$$$$$$$$",
"$$$$$$$$$$$$$$$$$$$$$$O.*$,##::<<::##,$$.O$$$$$$$$$$$$$$$$$$$$$$",
"$$$$$$$$$$$$$$$$$$$$$$O.*$,##::<<::##,$$O.$$$$$$$$$$$$$$$$$$$$$$",
"$$$$$$$$$$$$$$$$$$$$$$O.*$,##::<<::##,$$.O$$$$$$$$$$$$$$$$$$$$$$",
"$$$$$$$$$$$$$$$$$$$$$$O.*$,##::<<::##,$$O.$$$$$$$$$$$$$$$$$$$$$$",
"$$$$$$$$$$$$$$$$$$$$$$..*$,##::<<::##,$$.O$$$$$$$$$$$$$$$$$$$$$$",
"$$$$$$$$$$$$$$$$$$$$$$O.*$,##::<<::##,$$OO$$$$$$$$$$$$$$$$$$$$$$",
"$$$$$$$$$$$$$$$$$$$$$$..&$,##::<<::##,$$.O$$$$$$$$$$$$$$$$$$$$$$",
"$$$$$$$$$$$$$$$$$$$$$$O.*$,##::<<::##,$$OO$$$$$$$$$$$$$$$$$$$$$$",
"$$$$$$$$$$$$$$$$$$$$$$..&$,##::<<::##,$$.O$$$$$$$$$$$$$$$$$$$$$$",
"$$$$$$$$$$$$$$$$$$$$$$O.*$,##::<<::##,$$OO$$$$$$$$$$$$$$$$$$$$$$",
"$$$$$$$$$$$$$$$$$$$$$$..&$,##::<<::##,$$.O$$$$$$$$$$$$$$$$$$$$$$",
"$$$$$$$$$$$$$$$$$$$$$$..&$,##::<<::##,$$.O$$$$$$$$$$$$$$$$$$$$$$",
"$$$$$$$$$$$$$$$$$$$$$$..&$,##::<<::##,$$.O$$$$$$$$$$$$$$$$$$$$$$",
"$$$$$$$$$$$$$$$$$$$$$$..&$,##::<<::##,$$.O$$$$$$$$$$$$$$$$$$$$$$",
"$$$$$$$$$$$$$$$$$$$$$$..&$,##::<<::##,$$OO$$$$$$$$$$$$$$$$$$$$$$",
"$$$$$$$$$$$$$$$$$$$$$$..$$,##::<<::##,$$.O$$$$$$$$$$$$$$$$$$$$$$",
"$$$$$$$$$$$$$$$$$$$$$$..&$,##::<<::##,$$OO$$$$$$$$$$$$$$$$$$$$$$",
"$$$$$$$$$$$$$$$$$$$$$$..$$*##::<<::##,$$.O$$$$$$$$$$$$$$$$$$$$$$",
"$$$$$$$$$$$$$$$$$$$$$$.O&$,##::>>::##,$$OO$$$$$$$$$$$$$$$$$$$$$$",
"$$$$$$$$$$$$$$$$$$$$$$O.$$*##-::::-##,$$OO$$$$$$$$$$$$$$$$$$$$$$",
"$$$$$$$$$$$$$$$$@%,$$$.O$$*###-::-###,$$OO$$@,%$$$$$$$$$$$$$$$$$",
"$$$$$$$$$$$$$$$$@%%$$$O.$$$*########,$$$OO$$@%%$$$$$$$$$$$$$$$$$",
"$$$$$$$$$$$$$$$$@@$$$$.O$$$$*######,$$$$OO$$@@$$$$$$$$$$$$$$$$$$",
"$$$$$$$$$$$$$$$$$$$$$$OO$$%$$*,*,,,$$%$$OO$$$$$$$$$$$$$$$$$$$$$$",
"*******************$*$OO$@$$$$$$$$$$@$$$OO**$******$*$*$*$******",
"                       O$$$$$$$$$$$$$$$$O                       ",
"                        $$**********$*$$                        ",
"X. .X...X. .X...X. .X.                     .X...X. .X...X. .X...",
"+. ++X.++. ++X.++. ++X.                  . ++X.++. ++X.++. ++X.+",
"+. ++XX++. ++XX++. ++XX+.. .X...X. .X...X. ++XX++. ++XX++. ++XX+",
"+. ++XX++. ++XX++. ++XX++. ++XX++. ++XX++. ++XX++. ++XX++. ++XX+",
"+X.++XX++X.++XX++X.++XX++X.++XX++X.++XX++X.++XX++X.++XX++X.++XX+",
"+. ++XX++. ++XX++. ++XX++. ++XX++. ++XX++. ++XX++. ++XX++. ++XX+",
"+X.++XX++X.++XX++X.++XX++X.++XX++X.++XX++X.++XX++X.++XX++X.++XX+",
"+X ++XX++X ++XX++X ++XX++X ++XX++X ++XX++X ++XX++X ++XX++X ++XX+",
"+X.++XX++X.++XX++X.++XX++X.++XX++X.++XX++X.++XX++X.++XX++X.++XX+",
"+X.++XX++X.++XX++X.++XX++X.++XX++X.++XX++X.++XX++X.++XX++X.++XX+",
"+..++XX++..+XXX++..++XX++..+XXX++..++XX++..+XXX++..++XX++..+XXX+",
"+X.++XX++X.++XX++X.++XX++X.++XX++X.++XX++X.++XX++X.++XX++X.++XX+",
"X. +XXX+X. +XXX+X. +XXX+X. +XXX+X. +XXX+X. +XXX+X. +XXX+X. +XXX+",
"+..X+XX++..X+XX++..X+XX++..X+XX++..X+XX++..X+XX++..X+XX++..X+XX+",
"X. +XX.+X. +XX.+X. +XX.+X. +XX.+X. +XX.+X. +XX.+X. +XX.+X. +XX.+",
"X  XX. XX  XX. XX  XX. XX  XX. XX  XX. XX  XX. XX  XX. XX  XX. X",
"*********&*,*,&,&,,,,,,,,,,,,,,,,,,,,,,,,,,,,*,*,*,******&****&*",
"$$$$$$$$#$$$$$$$$$$$$$$$$#$$$$$$$$$$$$$#$#$$$$$$#$#$$$$$#$$$$$$$",
"$#$$$$$#$$$$$$$$$$$$$$$##$$$$$$$$$$$$$$$#$$$$$$$$#$$$$$#$$$$$$$$",
"#$$*#$$$$$$*#$$$$$$%#$$#$$$%#$$$$$$%#$$#$$$%#$$$#$$*#$$$$$$*#$$$",
"$$@##$$$$$@##$$$$$@##$#$#$@##$$$$$@##$$$$$@##$$#$$@##$$$$$@##$$#",
"#$@@$$$$$$@@$$$$$$@@$$$#$$@@$$$$$$@@$$$$$$@@$$##$$@@$$$$$$@@$$#$",
"$$$$$$$$$$$$$$$$$$$$$$#$$$$$$$$$$$$$#$$$$$$$$$#$$$$$$$$$$$$$$#$#",
"@oooooo@o@o@@@@@@@o@o@.@.@....@.@@@@@@@@o@o@@o@o@oooooo@o@o@@@@@"
};
