/* XPM */
static char *tech_texture_11678366330[] = {
/* columns rows colors chars-per-pixel */
"64 64 12 1 ",
"  c black",
". c #141413",
"X c #1C1C1B",
"o c #2F1C17",
"O c #28221F",
"+ c #292A28",
"@ c #382B2F",
"# c #4B3F38",
"$ c #383F40",
"% c #464D4F",
"& c #536265",
"* c #62797E",
/* pixels */
"                                                                ",
"%%%%%%%%%%%%%$%$%%%%%%%%%%$%$$$. %%%%%%%%%%%%%%%%%%%%%%%%%%$%$%%",
"$$$$$$$$$$$$$$$$$$$$$$$$$$$$$$$. %$$$$$$$$$$$$$$$$$$$$$$$$$$$$$$",
"$$$$$$$$$$$$$$$$$$$$$$$$$$$$$$$. %$$$$$$$$$$$$$$$$$$$$$$$$$$$$$$",
"$$$$$$$$$$$$$$$$$$$$$$$$$@*%$$$. %$@*%$$$$$$$$$$$$$$$$$$$$$$$$$$",
"$$$$$$$$$$$$$$$$$$$$$$$$$@%%$$$. %$@%%$$$$$$$$$$$$$$$$$$$$$$$$$$",
"$$$$$$$$$$$$$$$$$$$$$$$$$@@@$$$. %$@@$$$$$$$$$$$$$$$$$$$$$$$$$$$",
"$$$$$$$$$$$$$$$$$$$$$$$$$$@@$$$. %$$$$$$$$$$$$$$$$$$$$$$$$$$$$$$",
"%%%%%%%%%%%%%%%%%%%%%%%%%%##%%%O.*%%%%%%%%%%%%%%%%%%%%%%%%%%%%%%",
"$$$$$$$$$$$$$$$$$$$$$$$$$$@$$$$. %$$$$$$$$$$$$$$$$$$$$$$$$$$$$$$",
"%%%%%%%%%%%%%%%%%%%%%%%%%%%#%%%O.*%%%%%%%%%%%%%%%%%%%%%%%%%%%%%%",
"%%%%%%%%%%%%%%%%%%%%%%%%%%#%%%%. *%%%%%%%%%%%%%%%%%%%%%%%%%%%%%%",
"%%%%%%%%%%%%%%%%%%%%%%%%%%%%%%%O.*%%%%%%%%%%%%%%%%%%%%%%%%%%%%%%",
"%%%%%%%%%%%%%%%%%%%%%%%%%%%%%%%O.*%%%%%%%%%%%%%%%%%%%%%%%%%%%%%%",
"%%%%%%%%%%%%%%%%%%%%%%%%%%%%%%%O.*%%%%%%%%%%%%%%%%%%%%%%%%%%%%%%",
"%%%%%%%%%%%%%%%%%%%%%%%%%%%%%%%O.*%%%%%%%%%%%%%%%%%%%%$%%%%%%%%%",
"%%%%%%%%%%%%%%%%%%%%%%%%%%%%%%%O.*%%%%%%%%%%%%%%%%%%%$%%%%%%%%%%",
"%%%%%%%%%%%%%%%%%%%%%%%%%%%%%%%..&%%%%%%%%%%%%%%%%%$$&%%%%%%%%%%",
"%%%%%%%%%%%%%%%%%%%%%%%%%%%%%%%O.*%%%%%%%%%%%%%%%$@$&%%%%%%%%%%%",
"%%%%%%%%%%%%%%%%%%%%%%%%%%%%%%%..&%%%%%%%%%%%%$$@$&%%%%$%%%%%%%%",
"%%%%%%%%%%%%%%%%%%%%%%%%%%%%%%%O.*%%%%%%%%%$$@$*&%%%%$$%%%%%%%%%",
"%%%%%%%%%%%%%%%%%%%%%%%%%%%%%%%..&%%%%%%$$@$*&%%%%$@$&%%%%%%%%%%",
"%%%%%%%%%%%%%%%%%%%%%%%%%%%%%%%O.&%%%%%%&*&%%%%$$@$&%%%%%$%%%%%%",
"%%%%%%%%%%%%%%%%%%%%%%%%%%%%%%%..&%%%%%%%%%%$$@$*&%%%%%$$%%%%%%%",
"%%%%%%%%%%%%%%%%%%%%%%%%%%%%%%%..&%%%%%%%$$@$*&%%%%%$$$&%%%%%%%%",
"%%%%%%%%%%%%%%%%%%%%%%%%%%%%%%%..&%%%%%%&**&%%%%%$$@$&%%%%%%%%%%",
"%%%%%%%%%%%%%%%%%%%%%%%%%%%%%%%..%%%%%%%%%%%%$$@@$*&%%%%%%%%%%%%",
"%%%%%%%%%%%%%%%%%%%%%%%%%%%%%%%..&%%%%%%%%$@@$&*&%%%%%%%%%%%%%%%",
"%%%%%%%%%%%%%%%%%%%%%%%%%%%%%%%..%%%%%%%%&**&%%%%%%%%%%%%%%%%%%%",
"%%%%%%%%%%%%%%%%%%%%%%%%%%%%%%%..&%%%%%%%%%%%%%%%%%%%%%%%%%%%%%%",
"%%%%%%%%%%%%%%%%%%%%%%%%%%%%%%%..%%%%%%%%%%%%%%%%%%%%%%%%%%%%%%%",
"%%%%%%%%%%%%%%%%%%%%%%%%%%%%%%%.O%%%%%%%%%%%%%%%%%%%%%%%%%%%%%%%",
"%%%%%%%%%%%%%%%%%%%%%%%%%%%%%%%O.%%%%%%%%%%%%%%%%%%%%%%%%%%%%%%%",
"%%%%%%%%%%%%%%%%%%%%%%%%%@*$%%%.O%%@*$%%%%%%%%%%%%%%%%%%%%%%%%%%",
"%%%%%%%%%%%%%%%%%%%%%%%%%@$$%%%O.%%@$$%%%%%%%%%%%%%%%%%%%%%%%%%%",
"%%%%%%%%%%%%%%%%%%%%%%%%%@@%%%%.O%%@@%%%%%%%%%%%%%%%%%%%%%%%%%%%",
"%%%%%%%%%%%%%%%%%%%%%%%%%%%%%%%OO%%%%%%%%%%%%%%%%%%%%%%%%%%%%%%%",
"****************************%*%OO%*%*******%*%*%***%*%*%*%******",
"                                                                ",
"                                                                ",
"X. .X...X. .X...X. .X...X. .X...X. .X...X. .X...X. .X...X. .X...",
"+. ++X.++. ++X.++. ++X.++. ++X.++. ++X.++. ++X.++. ++X.++. ++X.+",
"+. ++XX++. ++XX++. ++XX++. ++XX++. ++XX++. ++XX++. ++XX++. ++XX+",
"+. ++XX++. ++XX++. ++XX++. ++XX++. ++XX++. ++XX++. ++XX++. ++XX+",
"+X.++XX++X.++XX++X.++XX++X.++XX++X.++XX++X.++XX++X.++XX++X.++XX+",
"+. ++XX++. ++XX++. ++XX++. ++XX++. ++XX++. ++XX++. ++XX++. ++XX+",
"+X.++XX++X.++XX++X.++XX++X.++XX++X.++XX++X.++XX++X.++XX++X.++XX+",
"+X ++XX++X ++XX++X ++XX++X ++XX++X ++XX++X ++XX++X ++XX++X ++XX+",
"+X.++XX++X.++XX++X.++XX++X.++XX++X.++XX++X.++XX++X.++XX++X.++XX+",
"+X.++XX++X.++XX++X.++XX++X.++XX++X.++XX++X.++XX++X.++XX++X.++XX+",
"+..++XX++..+XXX++..++XX++..+XXX++..++XX++..+XXX++..++XX++..+XXX+",
"+X.++XX++X.++XX++X.++XX++X.++XX++X.++XX++X.++XX++X.++XX++X.++XX+",
"X. +XXX+X. +XXX+X. +XXX+X. +XXX+X. +XXX+X. +XXX+X. +XXX+X. +XXX+",
"+..X+XX++..X+XX++..X+XX++..X+XX++..X+XX++..X+XX++..X+XX++..X+XX+",
"X. +XX.+X. +XX.+X. +XX.+X. +XX.+X. +XX.+X. +XX.+X. +XX.+X. +XX.+",
"X  XX. XX  XX. XX  XX. XX  XX. XX  XX. XX  XX. XX  XX. XX  XX. X",
"*********&****&*&*&*&*&&&&&&*&*&*&***********************&****&*",
"%%%%%%%%$%%%%%%%%%%%%%%%%$%%%%%%%%%%%%%$%$%%%%%%$%$%%%%%$%%%%%%%",
"%$%%%%%$%%%%%%%%%%%%%%%$$%%%%%%%%%%%%%%%$%%%%%%%%$%%%%%$%%%%%%%%",
"$%%*$%%%%%%*$%%%%%%*$%%$%%%*$%%%%%%*$%%$%%%*$%%%$%%*$%%%%%%*$%%%",
"%%@$$%%%%%@$$%%%%%@$$%$%$%@$$%%%%%@$$%%%%%@$$%%$%%@$$%%%%%@$$%%$",
"$%@@%%%%%%@@%%%%%%@@%%%$%%@@%%%%%%@@%%%%%%@@%%$$%%@@%%%%%%@@%%$%",
"%%%%%%%%%%%%%%%%%%%%%%$%%%%%%%%%%%%%$%%%%%%%%%$%%%%%%%%%%%%%%$%$",
"@oooooo@o@o@@@@@@@o@o@.@.@....@.@@@@@@@@o@o@@o@o@oooooo@o@o@@@@@"
};
