/* XPM */
static char *_0d79459598b44d0dcb844e2bcf8e9da2fja962KgYgCDjNN[] = {
/* columns rows colors chars-per-pixel */
"64 64 14 1 ",
"  c black",
". c #141413",
"X c #1C1C1B",
"o c #2F1C17",
"O c #28221F",
"+ c #292A28",
"@ c #382B2F",
"# c #4B3F38",
"$ c #383F40",
"% c #464D4F",
"& c #536265",
"* c #62797E",
"= c #9F7315",
"- c #C0A436",
/* pixels */
"                                                                ",
"%%%%%%%%%%%%%$%$%$%$$$. %%%%%%$%$%$%$$$$  $$%$%$%%%%%%%%%%%$%$%%",
"$$$$$$$$$$$$$$$$$$$$$$. %$$$$$$$$$$$$$$$  $$$$$$$$$$$$$$$$$$$$$$",
"$$$$$$$$$$$$$$$$$$$$$$. %$*$$$$$$$$$$*$$  $$$$$$$$$$$$$$$$$$$$$$",
"$$$$$$$$$$$$$$$$@*%$$$. %@$$$$$$$$$$@$$$  $$@*%$$$$$$$$$$$$$$$$$",
"$$$$$$$$$$$$$$$$@%%$$$. %$$$$$$$$$$$$$$$ .$$@%%$$$$$$$$$$$$$$$$$",
"$$$$$$$$@$$$$$$$@@$$$$. %$$$$$$$$$$$$$$$. $$@@@$$$$$$$$$$$$$$$$$",
"$$$$$$$@.@$$$$$$$$$$$$. %$$$$$$$$$$$$$$$ .$$$@@$$$$$$$$$$$$$$$$$",
"%%%%%%%###%%%%%%%%%%%%O.%$$$$$$$$$$$$$$$. %%%##%%%%%%%%%%%%%%%%%",
"$$$$$$$@@@$$$$%$%$$$$$. %$$$$$$$$$$$$$$$ .$$$@$$$$$$%$%$%$$$$$$$",
"%%%%%%%##%%%%%%%%%%%%%O.*%%%%%%%%%%%%%%%. %%%%#%%%%%%%%%%%%%%%%%",
"%%%%%%%###%%%%%%%%%%%%. %$$$$$$$%$%$$%$$ O%%%#%%%%%%%%%%%%%%%%%%",
"%%%%%%%##%%%%%%%%%%%%%O.*%%%%%%%%%%%%%%%O.%%%%%%%%%%%%%%%%%%%%%%",
"%%%%%%%##%%%%%%%%%%%%%O.*%%%%%%%%%%%%%%%.O%%%%%%%%%%%%%%%%%%%%%%",
"%%%%%%%%#%%%%%%%%%%%%%O.*%%%%%%%%%%%%%%%O.%%%%%%%%%%%%%%%%%%%%%%",
"%%%%%%%##%%%%%%%%%%%%%O.*%%%%%%%%%%%%%%%.O%%%%%%%%%%%%%%%%%%%%%%",
"%%%%%%%%#%%%%%%%%%%%%%O.*%%%%%%%%%%%%%%%O.%%%%%%%%%%%%%%%%%%%%%%",
"%%%%%%%%#%%%%%%%%%%%%%..*%%%%%%%%%%%%%%%.O%%%%%%%%%%%%%%%%%%%%%%",
"%%%%%%%%%%%%%%%%%%%%%%O.*%%%%%%%%%%%%%%%OO%%%%%%%%%%%%%%%%%%%%%%",
"%%%%%%%%#%%%%%%%%%%%%%..&%=%==%%%==%%%%%.O%%%%%%%%%%%%%%%%%%$&%%",
"%%%%%%%%%%%%%%%%%%%%%%O.*%%====%%=%%%%%%OO%%%%%%%%%%%%%%%%%$*%%%",
"%%%%%%%%%%%%%%%%%%%%%%..&%%%%==%%%=%==%%.O%%%%%%%%%%%%%%%%%&%%%%",
"%%%%%%%%%%%%%%%%%%%%%%O.*%%%%==%%=%%==%%OO%%%%%%%%%%%%%%%$%%%%%%",
"%%%%%%%%%%%%%%%%%%%%%%..&%%%%==%%%====%%.O%%%%%%%%%%%%$%$%%%%%%%",
"%%%%%%%%%%%%%%%%%%%%%%..&%%%%=%%%%====%%.O%%%%%%%%%%%$&$%$&%%%%%",
"%%%%%%%%%%%%%%%%%%%%%%..&%%%%%=%%%%%==%%.O%%%%%%%%%%$*$%$*%%%%%%",
"%%%%%%%%%%%%%%%%%%%%%%..&%%%%=%%%%%%==%%.O%%%%%%%%%$*%%$&%%%%%%%",
"%%%%%%%%%%%%%%%%%%%%%%..&%%%%%=%%%%%==%%OO%%%%%%%%%&%%$%%%%%%%%%",
"====%=====%=%==%=%===%..%%%%%%%%%%%%%%%%.O%%=%===%-==%=======%-=",
"===%===%===%========%%..&%%%%%%%%%%%%%%%OO%=%===%-=======%==%-==",
"==%===%=%===%======%=%..%=============%%.O%%===%======%=%===-===",
"=%%%=%%%=%=%========%%.O&============%=%OO%==========%=%%%======",
"%%%%%%%%%%%%%%%%%%%%%%O.%=%===========%%OO%%%%%%%%%%%%%%%%%%%%%%",
"%%%%%%%%%%%%%%%%@*$%%%.O%%=%=%=========%OO%%@*$%%%%%%%%%%%%%%%%%",
"%%%%%%%%%%%%%%%%@$$%%%O.%%%%%%%%%%%%%%%%OO%%@$$%%%%%%%%%%%%%%%%%",
"%%%%%%%%%%%%%%%%@@%%%%.O%%%%%%%%%%%%%%%%OO%%@@%%%%%%%%%%%%%%%%%%",
"%%%%%%%%%%%%%%%%%%%%%%OO%%*%%%%%%%%%%*%%OO%%%%%%%%%%%%%%%%%%%%%%",
"*******************%*%OO%@%%%%%%%%%%@%%%OO%*%******%*%*%*%******",
"                       O%%%%%%%%%%%%%%%%O                       ",
"                        %%**********%*%%                        ",
"X. .X...X. .X...X. .X.                     .X...X. .X...X. .X...",
"+. ++X.++. ++X.++. ++X.                  . ++X.++. ++X.++. ++X.+",
"+. ++XX++. ++XX++. ++XX+.. .X...X. .X...X. ++XX++. ++XX++. ++XX+",
"+. ++XX++. ++XX++. ++XX++. ++XX++. ++XX++. ++XX++. ++XX++. ++XX+",
"+X.++XX++X.++XX++X.++XX++X.++XX++X.++XX++X.++XX++X.++XX++X.++XX+",
"+. ++XX++. ++XX++. ++XX++. ++XX++. ++XX++. ++XX++. ++XX++. ++XX+",
"+X.++XX++X.++XX++X.++XX++X.++XX++X.++XX++X.++XX++X.++XX++X.++XX+",
"+X ++XX++X ++XX++X ++XX++X ++XX++X ++XX++X ++XX++X ++XX++X ++XX+",
"+X.++XX++X.++XX++X.++XX++X.++XX++X.++XX++X.++XX++X.++XX++X.++XX+",
"+X.++XX++X.++XX++X.++XX++X.++XX++X.++XX++X.++XX++X.++XX++X.++XX+",
"+..++XX++..+XXX++..++XX++..+XXX++..++XX++..+XXX++..++XX++..+XXX+",
"+X.++XX++X.++XX++X.++XX++X.++XX++X.++XX++X.++XX++X.++XX++X.++XX+",
"X. +XXX+X. +XXX+X. +XXX+X. +XXX+X. +XXX+X. +XXX+X. +XXX+X. +XXX+",
"+..X+XX++..X+XX++..X+XX++..X+XX++..X+XX++..X+XX++..X+XX++..X+XX+",
"X. +XX.+X. +XX.+X. +XX.+X. +XX.+X. +XX.+X. +XX.+X. +XX.+X. +XX.+",
"X  XX. XX  XX. XX  XX. XX  XX. XX  XX. XX  XX. XX  XX. XX  XX. X",
"*********&****&*&*&*&*&&&&&&*&*&*&***********************&****&*",
"%%%%%%%%$%%%%%%%%%%%%%%%%$%%%%%%$%%%%%%%$%%%%%%%$%$%%%%%$%%%%%%%",
"%$%%%%%$%%%%%%%%%%%%%%%$$%%%%%%%%%%%%%%###%%%%%%%$%%%%%$%%%%%%%%",
"$%%*$%%%%%%*$%%%%%%*$%%$%%#*$%%%%%%*$%#%#%%*$%%%$%%*$%%%%%%*$%%%",
"%%@$$%%%%%@$$%%%%%@$$%$%$%@$$%%$%%@$$%%#%%@$$%%$%%@$$%%%%%@$$%%$",
"$%@@%%%%%%@@%%%%%%@@%%%$%%@@#%%%%%@@%%#%%%@@%%$$%%@@%%%%%%@@%%$%",
"%%%%%%%%%%%%%%%%%%%%%%$%%%%##%%%%%%%%#%%%%%%%%$%%%%%%%%%%%%%%$%$",
"@oooooo@o@o@@@@@@@o@o@.@.@....@.@@@@@@@@o@o@@o@o@oooooo@o@o@@@@@"
};
